ngram	w1	w2	n
di_belakang	di	belakang	576
latar_belakang	latar	belakang	535
belakangan_ini	belakangan	ini	499
bagian_belakang	bagian	belakang	198
lini_belakang	lini	belakang	154
yang_belakangan	yang	belakangan	147
ke_belakang	ke	belakang	145
pemain_belakang	pemain	belakang	138
bertolak_belakang	bertolak	belakang	106
tahun_belakangan	tahun	belakangan	104
belakang_dengan	belakang	dengan	98
dari_belakang	dari	belakang	93
di_belakangnya	di	belakangnya	93
berlatar_belakang	berlatar	belakang	92
belakang_dan	belakang	dan	91
belakang_rumah	belakang	rumah	86
belakang_yang	belakang	yang	73
dan_belakang	dan	belakang	62
tulang_belakang	tulang	belakang	61
pintu_belakang	pintu	belakang	47
kamera_belakang	kamera	belakang	44
belakang_pendidikan	belakang	pendidikan	42
hari_belakangan	hari	belakangan	40
belakangan_diketahui	belakangan	diketahui	38
latar_belakangnya	latar	belakangnya	37
waktu_belakangan	waktu	belakangan	34
barisan_belakang	barisan	belakang	31
terjadi_belakangan	terjadi	belakangan	31
halaman_belakang	halaman	belakang	29
belakang_mobil	belakang	mobil	26
paling_belakang	paling	belakang	26
bulan_belakangan	bulan	belakangan	25
arah_belakang	arah	belakang	24
belakang_rumahnya	belakang	rumahnya	23
itu_belakangan	itu	belakangan	23
belakang_itu	belakang	itu	22
belakang_kantor	belakang	kantor	22
belakang_mereka	belakang	mereka	22
yang_melatarbelakangi	yang	melatarbelakangi	22
belakang_panggung	belakang	panggung	20
belakang_ini	belakang	ini	18
belakang_layar	belakang	layar	18
belakang_untuk	belakang	untuk	18
belakang_dari	belakang	dari	17
belakang_sebagai	belakang	sebagai	17
dilatarbelakangi_oleh	dilatarbelakangi	oleh	17
ini_belakangan	ini	belakangan	17
ini_dilatarbelakangi	ini	dilatarbelakangi	17
dan_belakangan	dan	belakangan	16
setahun_belakangan	setahun	belakangan	16
belakang_agama	belakang	agama	15
belakang_kepala	belakang	kepala	15
belakangan_mulai	belakangan	mulai	14
namun_belakangan	namun	belakangan	14
roda_belakang	roda	belakang	14
belakang_di	belakang	di	13
belakang_saya	belakang	saya	13
belakang_gawang	belakang	gawang	12
belakang_meja	belakang	meja	12
belakangan_banyak	belakangan	banyak	12
belakangan_kian	belakangan	kian	12
belakangan_sering	belakangan	sering	12
bagian_belakangnya	bagian	belakangnya	11
belakang_akan	belakang	akan	11
belakang_budaya	belakang	budaya	11
belakang_gedung	belakang	gedung	11
belakang_korban	belakang	korban	11
dan_keterbelakangan	dan	keterbelakangan	11
belakang_atau	belakang	atau	10
belakang_hingga	belakang	hingga	10
belakang_juga	belakang	juga	10
belakang_kami	belakang	kami	10
belakang_pasar	belakang	pasar	10
belakang_sejarah	belakang	sejarah	10
belakang_tim	belakang	tim	10
belakangan_muncul	belakangan	muncul	10
depan_belakang	depan	belakang	10
pekan_belakangan	pekan	belakangan	10
sektor_belakang	sektor	belakang	10
tersebut_belakangan	tersebut	belakangan	10
yang_dilatarbelakangi	yang	dilatarbelakangi	10
ban_belakang	ban	belakang	9
belakang_berbeda	belakang	berbeda	9
belakang_dia	belakang	dia	9
belakang_kata	belakang	kata	9
belakang_pengusaha	belakang	pengusaha	9
belakang_politik	belakang	politik	9
belakang_tersebut	belakang	tersebut	9
belakangan_ada	belakangan	ada	9
belakangan_menjadi	belakangan	menjadi	9
belakangnya_sebagai	belakangnya	sebagai	9
belakang_karena	belakang	karena	8
belakang_kita	belakang	kita	8
belakang_sehingga	belakang	sehingga	8
belakang_seperti	belakang	seperti	8
belakang_serta	belakang	serta	8
belakang_tapi	belakang	tapi	8
belakangan_juga	belakangan	juga	8
belakangan_tidak	belakangan	tidak	8
karena_belakangan	karena	belakangan	8
keterbelakangan_mental	keterbelakangan	mental	8
mencuat_belakangan	mencuat	belakangan	8
belakang_13MP	belakang	13MP	7
belakang_bangunan	belakang	bangunan	7
belakang_bisa	belakang	bisa	7
belakang_kemudi	belakang	kemudi	7
belakang_kendaraan	belakang	kendaraan	7
belakang_masjid	belakang	masjid	7
belakang_profesi	belakang	profesi	7
belakangan_beredar	belakangan	beredar	7
belakangan_kata	belakangan	kata	7
belakangan_setelah	belakangan	setelah	7
berkembang_belakangan	berkembang	belakangan	7
nama_belakang	nama	belakang	7
tersebut_dilatarbelakangi	tersebut	dilatarbelakangi	7
bagasi_belakang	bagasi	belakang	6
belakang_eks	belakang	eks	6
belakang_foto	belakang	foto	6
belakang_hari	belakang	hari	6
belakang_ilmu	belakang	ilmu	6
belakang_keluarga	belakang	keluarga	6
belakang_lawan	belakang	lawan	6
belakang_menjadi	belakang	menjadi	6
belakang_militer	belakang	militer	6
belakang_pesawat	belakang	pesawat	6
belakang_saat	belakang	saat	6
belakang_sekolah	belakang	sekolah	6
belakang_ternyata	belakang	ternyata	6
belakang_tidak	belakang	tidak	6
belakangan_dan	belakangan	dan	6
belakangan_karena	belakangan	karena	6
belakangan_saya	belakangan	saya	6
belakangan_semakin	belakangan	semakin	6
belakangan_yang	belakangan	yang	6
belakangnya_dengan	belakangnya	dengan	6
dibagian_belakang	dibagian	belakang	6
dilatarbelakangi_karena	dilatarbelakangi	karena	6
kaca_belakang	kaca	belakang	6
kalau_belakangan	kalau	belakangan	6
masyarakat_belakangan	masyarakat	belakangan	6
mengalami_keterbelakangan	mengalami	keterbelakangan	6
muncul_belakangan	muncul	belakangan	6
ruang_belakang	ruang	belakang	6
sisi_belakang	sisi	belakang	6
atau_belakang	atau	belakang	5
belakang_aksi	belakang	aksi	5
belakang_bisnis	belakang	bisnis	5
belakang_de-ngan	belakang	de-ngan	5
belakang_itulah	belakang	itulah	5
belakang_ke	belakang	ke	5
belakang_keilmuan	belakang	keilmuan	5
belakang_ketika	belakang	ketika	5
belakang_kompleks	belakang	kompleks	5
belakang_maupun	belakang	maupun	5
belakang_membuat	belakang	membuat	5
belakang_para	belakang	para	5
belakang_pekerjaan	belakang	pekerjaan	5
belakang_pendidikannya	belakang	pendidikannya	5
belakang_tak	belakang	tak	5
belakang_tempat	belakang	tempat	5
belakang_terdapat	belakang	terdapat	5
belakang_tetapi	belakang	tetapi	5
belakangan_dia	belakangan	dia	5
belakangan_hanya	belakangan	hanya	5
belakangan_ia	belakangan	ia	5
belakangan_kerap	belakangan	kerap	5
belakangan_marak	belakangan	marak	5
belakangan_memang	belakangan	memang	5
belakangan_tak	belakangan	tak	5
belakangan_telah	belakangan	telah	5
belakangan_terus	belakangan	terus	5
belakangnya_ada	belakangnya	ada	5
ber-tolak_belakang	ber-tolak	belakang	5
datang_belakangan	datang	belakangan	5
itu_dilatarbelakangi	itu	dilatarbelakangi	5
kanan_belakang	kanan	belakang	5
kepala_belakang	kepala	belakang	5
kursi_belakang	kursi	belakang	5
lewat_belakang	lewat	belakang	5
minggu_belakangan	minggu	belakangan	5
paha_belakang	paha	belakang	5
pemain_belakangnya	pemain	belakangnya	5
tahun-tahun_belakangan	tahun-tahun	belakangan	5
tembok_belakang	tembok	belakang	5
belakang_berbagai	belakang	berbagai	4
belakang_garis	belakang	garis	4
belakang_harus	belakang	harus	4
belakang_kampus	belakang	kampus	4
belakang_kawasan	belakang	kawasan	4
belakang_kedua	belakang	kedua	4
belakang_kursi	belakang	kursi	4
belakang_megapiksel	belakang	megapiksel	4
belakang_menggunakan	belakang	menggunakan	4
belakang_oleh	belakang	oleh	4
belakang_pada	belakang	pada	4
belakang_ruang	belakang	ruang	4
belakang_sang	belakang	sang	4
belakang_sebelah	belakang	sebelah	4
belakang_setelah	belakang	setelah	4
belakang_sudah	belakang	sudah	4
belakang_truk	belakang	truk	4
belakang_warung	belakang	warung	4
belakangan_di	belakangan	di	4
belakangan_dike-tahui	belakangan	dike-tahui	4
belakangan_diketa-hui	belakangan	diketa-hui	4
belakangan_justru	belakangan	justru	4
belakangan_kelihatan	belakangan	kelihatan	4
belakangan_makin	belakangan	makin	4
belakangan_mendapat	belakangan	mendapat	4
belakangan_selalu	belakangan	selalu	4
belakangnya_sudah	belakangnya	sudah	4
berada_dibelakang	berada	dibelakang	4
bila_belakangan	bila	belakangan	4
hujan_belakangan	hujan	belakangan	4
jalan_belakang	jalan	belakang	4
jendela_belakang	jendela	belakang	4
juga_dilatarbelakangi	juga	dilatarbelakangi	4
kamar_belakang	kamar	belakang	4
marak_belakangan	marak	belakangan	4
melatar_belakangi	melatar	belakangi	4
membelakangi_penonton	membelakangi	penonton	4
mengatakan_belakangan	mengatakan	belakangan	4
punggung_belakang	punggung	belakang	4
rem_belakang	rem	belakang	4
tapi_belakangan	tapi	belakangan	4
teras_belakang	teras	belakang	4
tetapi_belakangan	tetapi	belakangan	4
tulang_belakangnya	tulang	belakangnya	4
urusan_belakangan	urusan	belakangan	4
4G_belakangan	4G	belakangan	3
ba-gian_belakang	ba-gian	belakang	3
belakang_16MP	belakang	16MP	3
belakang_8MP	belakang	8MP	3
belakang_ada	belakang	ada	3
belakang_agar	belakang	agar	3
belakang_akibat	belakang	akibat	3
belakang_anggota	belakang	anggota	3
belakang_asal	belakang	asal	3
belakang_bahkan	belakang	bahkan	3
belakang_bukan	belakang	bukan	3
belakang_buku	belakang	buku	3
belakang_demi	belakang	demi	3
belakang_era	belakang	era	3
belakang_gereja	belakang	gereja	3
belakang_gunung	belakang	gunung	3
belakang_jadi	belakang	jadi	3
belakang_jelas	belakang	jelas	3
belakang_justru	belakang	justru	3
belakang_kamera	belakang	kamera	3
belakang_kegiatan	belakang	kegiatan	3
belakang_kehidupan	belakang	kehidupan	3
belakang_kereta	belakang	kereta	3
belakang_lebih	belakang	lebih	3
belakang_mantan	belakang	mantan	3
belakang_mata	belakang	mata	3
belakang_melihat	belakang	melihat	3
belakang_mengalami	belakang	mengalami	3
belakang_mulai	belakang	mulai	3
belakang_munculnya	belakang	munculnya	3
belakang_nama	belakang	nama	3
belakang_pelaksanaan	belakang	pelaksanaan	3
belakang_saja	belakang	saja	3
belakang_salah	belakang	salah	3
belakang_sampai	belakang	sampai	3
belakang_sepeda	belakang	sepeda	3
belakang_sistem	belakang	sistem	3
belakang_sosial	belakang	sosial	3
belakang_striker	belakang	striker	3
belakang_telah	belakang	telah	3
belakangan_dalam	belakangan	dalam	3
belakangan_dengan	belakangan	dengan	3
belakangan_dibantah	belakangan	dibantah	3
belakangan_jadi	belakangan	jadi	3
belakangan_mengaku	belakangan	mengaku	3
belakangan_sangat	belakangan	sangat	3
belakangan_sudah	belakangan	sudah	3
belakangan_ternyata	belakangan	ternyata	3
belakangnya_dan	belakangnya	dan	3
beranda_belakang	beranda	belakang	3
beredar_belakangan	beredar	belakangan	3
bertolak-belakang_dengan	bertolak-belakang	dengan	3
dan_belakangnya	dan	belakangnya	3
dari_keterbelakangan	dari	keterbelakangan	3
di_belakang-nya	di	belakang-nya	3
dibelakang_layar	dibelakang	layar	3
diketahui_belakangan	diketahui	belakangan	3
dilatar_belakangi	dilatar	belakangi	3
dilatarbelakangi_adanya	dilatarbelakangi	adanya	3
dilatarbelakangi_keinginan	dilatarbelakangi	keinginan	3
dinding_belakang	dinding	belakang	3
disebut_belakangan	disebut	belakangan	3
duduk_dibelakang	duduk	dibelakang	3
garis_belakang	garis	belakang	3
gir_belakang	gir	belakang	3
hingga_belakang	hingga	belakang	3
juga_belakangan	juga	belakangan	3
kami_belakangan	kami	belakangan	3
kebun_belakang	kebun	belakang	3
kompleks_belakang	kompleks	belakang	3
lampu_belakang	lampu	belakang	3
lapangan_belakang	lapangan	belakang	3
media_belakangan	media	belakangan	3
melatarbelakangi_sehingga	melatarbelakangi	sehingga	3
memang_belakangan	memang	belakangan	3
membelakangi_sungai	membelakangi	sungai	3
menghangat_belakangan	menghangat	belakangan	3
meningkat_belakangan	meningkat	belakangan	3
merebak_belakangan	merebak	belakangan	3
saling_membelakangi	saling	membelakangi	3
sendiri_belakangan	sendiri	belakangan	3
tahun_belakang	tahun	belakang	3
terbelakang_dan	terbelakang	dan	3
terbelakang_yang	terbelakang	yang	3
tren_belakangan	tren	belakangan	3
tribun_belakang	tribun	belakang	3
urusan_belakang	urusan	belakang	3
yang_berlatarbelakang	yang	berlatarbelakang	3
yang_membelakangi	yang	membelakangi	3
agama_belakangan	agama	belakangan	2
air_belakangan	air	belakangan	2
anehnya_belakangan	anehnya	belakangan	2
areal_belakang	areal	belakang	2
bagian-bagian_belakang	bagian-bagian	belakang	2
bahwa_belakangan	bahwa	belakangan	2
bak_belakang	bak	belakang	2
bangku_belakang	bangku	belakang	2
belakang_12MP	belakang	12MP	2
belakang_andalan	belakang	andalan	2
belakang_apalagi	belakang	apalagi	2
belakang_apapun	belakang	apapun	2
belakang_bagi	belakang	bagi	2
belakang_bagian	belakang	bagian	2
belakang_bahasa	belakang	bahasa	2
belakang_bahwa	belakang	bahwa	2
belakang_banyak	belakang	banyak	2
belakang_barisan	belakang	barisan	2
belakang_bebernya	belakang	bebernya	2
belakang_begitu	belakang	begitu	2
belakang_beresolusi	belakang	beresolusi	2
belakang_bermain	belakang	bermain	2
belakang_birokrat	belakang	birokrat	2
belakang_bodi	belakang	bodi	2
belakang_bus	belakang	bus	2
belakang_calon	belakang	calon	2
belakang_cukup	belakang	cukup	2
belakang_daerah	belakang	daerah	2
belakang_dalam	belakang	dalam	2
belakang_dapat	belakang	dapat	2
belakang_digelarnya	belakang	digelarnya	2
belakang_dijual	belakang	dijual	2
belakang_dua	belakang	dua	2
belakang_ekonomi	belakang	ekonomi	2
belakang_etnis	belakang	etnis	2
belakang_gorden	belakang	gorden	2
belakang_hanggar	belakang	hanggar	2
belakang_hitam	belakang	hitam	2
belakang_hunian	belakang	hunian	2
belakang_hutan	belakang	hutan	2
belakang_imbuhnya	belakang	imbuhnya	2
belakang_istana	belakang	istana	2
belakang_jam	belakang	jam	2
belakang_kamar	belakang	kamar	2
belakang_katanya	belakang	katanya	2
belakang_kebudayaan	belakang	kebudayaan	2
belakang_kekayaan	belakang	kekayaan	2
belakang_kemudian	belakang	kemudian	2
belakang_kemunculan	belakang	kemunculan	2
belakang_kepalanya	belakang	kepalanya	2
belakang_kerap	belakang	kerap	2
belakang_kiri	belakang	kiri	2
belakang_komodo	belakang	komodo	2
belakang_kosong	belakang	kosong	2
belakang_kultural	belakang	kultural	2
belakang_lainnya	belakang	lainnya	2
belakang_lapangan	belakang	lapangan	2
belakang_lawannya	belakang	lawannya	2
belakang_luar	belakang	luar	2
belakang_lutut	belakang	lutut	2
belakang_maka	belakang	maka	2
belakang_makam	belakang	makam	2
belakang_markas	belakang	markas	2
belakang_masih	belakang	masih	2
belakang_masing-masing	belakang	masing-masing	2
belakang_medis	belakang	medis	2
belakang_memang	belakang	memang	2
belakang_mengapa	belakang	mengapa	2
belakang_milik	belakang	milik	2
belakang_motor	belakang	motor	2
belakang_negara	belakang	negara	2
belakang_negara-negara	belakang	negara-negara	2
belakang_ombak	belakang	ombak	2
belakang_orang	belakang	orang	2
belakang_padahal	belakang	padahal	2
belakang_pebisnis	belakang	pebisnis	2
belakang_pegawai	belakang	pegawai	2
belakang_pelaku	belakang	pelaku	2
belakang_pemain	belakang	pemain	2
belakang_pemandangan	belakang	pemandangan	2
belakang_pembalap	belakang	pembalap	2
belakang_pembangunan	belakang	pembangunan	2
belakang_pembeli	belakang	pembeli	2
belakang_pembuatan	belakang	pembuatan	2
belakang_pen-didikan	belakang	pen-didikan	2
belakang_penemuan	belakang	penemuan	2
belakang_penetapan	belakang	penetapan	2
belakang_perkampungan	belakang	perkampungan	2
belakang_pertokoan	belakang	pertokoan	2
belakang_perumahan	belakang	perumahan	2
belakang_peserta	belakang	peserta	2
belakang_pintu	belakang	pintu	2
belakang_posisi	belakang	posisi	2
belakang_proyek	belakang	proyek	2
belakang_pun	belakang	pun	2
belakang_rombongan	belakang	rombongan	2
belakang_saksi	belakang	saksi	2
belakang_satu	belakang	satu	2
belakang_sebanyak	belakang	sebanyak	2
belakang_sebesar	belakang	sebesar	2
belakang_sebuah	belakang	sebuah	2
belakang_secara	belakang	secara	2
belakang_sejumlah	belakang	sejumlah	2
belakang_sementara	belakang	sementara	2
belakang_seniman	belakang	seniman	2
belakang_skuad	belakang	skuad	2
belakang_smartphone	belakang	smartphone	2
belakang_sopir	belakang	sopir	2
belakang_stasiun	belakang	stasiun	2
belakang_suku	belakang	suku	2
belakang_tebing	belakang	tebing	2
belakang_tegasnya	belakang	tegasnya	2
belakang_telinga	belakang	telinga	2
belakang_tengah	belakang	tengah	2
belakang_tentu	belakang	tentu	2
belakang_tepat	belakang	tepat	2
belakang_terjadinya	belakang	terjadinya	2
belakang_terlihat	belakang	terlihat	2
belakang_tersangka	belakang	tersangka	2
belakang_tertutup	belakang	tertutup	2
belakang_the	belakang	the	2
belakang_tiga	belakang	tiga	2
belakang_timnya	belakang	timnya	2
belakang_toko	belakang	toko	2
belakang_tubuhnya	belakang	tubuhnya	2
belakang_tugu	belakang	tugu	2
belakang_tujuan	belakang	tujuan	2
belakang_ucapnya	belakang	ucapnya	2
belakang_ujar	belakang	ujar	2
belakang_ujarnya	belakang	ujarnya	2
belakang_wanita	belakang	wanita	2
belakang_warga	belakang	warga	2
belakang_warna	belakang	warna	2
belakang_yakni	belakang	yakni	2
belakangan_adalah	belakangan	adalah	2
belakangan_aksi	belakangan	aksi	2
belakangan_ba-nyak	belakangan	ba-nyak	2
belakangan_bahwa	belakangan	bahwa	2
belakangan_berkembang	belakangan	berkembang	2
belakangan_berubah	belakangan	berubah	2
belakangan_cenderung	belakangan	cenderung	2
belakangan_di-ketahui	belakangan	di-ketahui	2
belakangan_disebut-sebut	belakangan	disebut-sebut	2
belakangan_dituding	belakangan	dituding	2
belakangan_gencar	belakangan	gencar	2
belakangan_hari	belakangan	hari	2
belakangan_harus	belakangan	harus	2
belakangan_hilang	belakangan	hilang	2
belakangan_ialah	belakangan	ialah	2
belakangan_industri	belakangan	industri	2
belakangan_itu	belakangan	itu	2
belakangan_kabar	belakangan	kabar	2
belakangan_kalah	belakangan	kalah	2
belakangan_ketika	belakangan	ketika	2
belakangan_khusus	belakangan	khusus	2
belakangan_le-gislator	belakangan	le-gislator	2
belakangan_lebih	belakangan	lebih	2
belakangan_masih	belakangan	masih	2
belakangan_melonjak	belakangan	melonjak	2
belakangan_memiliki	belakangan	memiliki	2
belakangan_memutuskan	belakangan	memutuskan	2
belakangan_mencaploknya	belakangan	mencaploknya	2
belakangan_menyusul	belakangan	menyusul	2
belakangan_mereka	belakangan	mereka	2
belakangan_minim	belakangan	minim	2
belakangan_orang	belakangan	orang	2
belakangan_orangtua	belakangan	orangtua	2
belakangan_pemerintah	belakangan	pemerintah	2
belakangan_pernyataan	belakangan	pernyataan	2
belakangan_pihak	belakangan	pihak	2
belakangan_populer	belakangan	populer	2
belakangan_rencana	belakangan	rencana	2
belakangan_saja	belakangan	saja	2
belakangan_santer	belakangan	santer	2
belakangan_sebagai	belakangan	sebagai	2
belakangan_sempat	belakangan	sempat	2
belakangan_semua	belakangan	semua	2
belakangan_sikap	belakangan	sikap	2
belakangan_situasi	belakangan	situasi	2
belakangan_tampak	belakangan	tampak	2
belakangan_terindikasi	belakangan	terindikasi	2
belakangan_terjadi	belakangan	terjadi	2
belakangan_terungkap	belakangan	terungkap	2
belakangan_terutama	belakangan	terutama	2
belakangan_tinggal	belakangan	tinggal	2
belakangan_turut	belakangan	turut	2
belakangan_ujarnya	belakangan	ujarnya	2
belakangan_upaya	belakangan	upaya	2
belakangi_munculnya	belakangi	munculnya	2
belakangnya_adalah	belakangnya	adalah	2
belakangnya_hanya	belakangnya	hanya	2
belakangnya_juga	belakangnya	juga	2
belakangnya_memiliki	belakangnya	memiliki	2
belakangnya_menggunakan	belakangnya	menggunakan	2
belakangnya_pada	belakangnya	pada	2
belakangnya_tak	belakangnya	tak	2
belakangnya_tidak	belakangnya	tidak	2
belakangnya_yakni	belakangnya	yakni	2
belakangnya_yang	belakangnya	yang	2
ber-latar_belakang	ber-latar	belakang	2
bergabung_belakangan	bergabung	belakangan	2
berhembus_belakangan	berhembus	belakangan	2
berlatarbelakang_pendidikan	berlatarbelakang	pendidikan	2
bertulang_belakang	bertulang	belakang	2
cover_belakang	cover	belakang	2
daerah_terbelakang	daerah	terbelakang	2
dan_latarbelakang	dan	latarbelakang	2
dan_terbelakang	dan	terbelakang	2
dan_terkebelakang	dan	terkebelakang	2
dasawarsa_belakangan	dasawarsa	belakangan	2
dekade_belakangan	dekade	belakangan	2
demo_belakangan	demo	belakangan	2
dibangun_belakangan	dibangun	belakangan	2
dibarisan_belakang	dibarisan	belakang	2
dibelakangnya_yaitu	dibelakangnya	yaitu	2
dibicarakan_belakangan	dibicarakan	belakangan	2
dilatarbelakangi_beberapa	dilatarbelakangi	beberapa	2
dilatarbelakangi_cerita	dilatarbelakangi	cerita	2
dilatarbelakangi_dendam	dilatarbelakangi	dendam	2
dilatarbelakangi_rasa	dilatarbelakangi	rasa	2
dilini_belakang	dilini	belakang	2
duduk_membelakangi	duduk	membelakangi	2
gigi_belakang	gigi	belakang	2
hangat_belakangan	hangat	belakangan	2
isu_belakangan	isu	belakangan	2
jam_belakangan	jam	belakangan	2
kabin_belakang	kabin	belakang	2
kaki_belakang	kaki	belakang	2
kamera_belakangnya	kamera	belakangnya	2
karena_dilatarbelakangi	karena	dilatarbelakangi	2
kawasan_belakang	kawasan	belakang	2
ke-pala_belakang	ke-pala	belakang	2
kemudian_belakangan	kemudian	belakangan	2
kenapa_belakangan	kenapa	belakangan	2
keterbelakangan_dan	keterbelakangan	dan	2
keterbelakangan_ujarnya	keterbelakangan	ujarnya	2
ketiga_belakang	ketiga	belakang	2
kiri_belakang	kiri	belakang	2
kolam_belakang	kolam	belakang	2
la-tar_belakang	la-tar	belakang	2
lantaran_belakangan	lantaran	belakangan	2
lebih_terbelakang	lebih	terbelakang	2
leher_belakang	leher	belakang	2
listrik_belakangan	listrik	belakangan	2
maupun_belakang	maupun	belakang	2
melatarbelakangi_berdirinya	melatarbelakangi	berdirinya	2
melatarbelakangi_diadakannya	melatarbelakangi	diadakannya	2
melatarbelakangi_kami	melatarbelakangi	kami	2
melon_belakangan	melon	belakangan	2
membelakangi_kamera	membelakangi	kamera	2
membelakangi_laut	membelakangi	laut	2
menabrak_belakang	menabrak	belakang	2
mengingat_belakangan	mengingat	belakangan	2
menilai_belakangan	menilai	belakangan	2
menurun_belakangan	menurun	belakangan	2
meski_belakangan	meski	belakangan	2
militer_belakang	militer	belakang	2
miras_belakangan	miras	belakangan	2
muda_belakangan	muda	belakangan	2
pagar_belakang	pagar	belakang	2
paling_belakangan	paling	belakangan	2
pe-main_belakang	pe-main	belakang	2
pebalap_dibelakangnya	pebalap	dibelakangnya	2
pekarangan_belakang	pekarangan	belakang	2
pemain-pemain_belakang	pemain-pemain	belakang	2
pengintai_belakang	pengintai	belakang	2
penumpang_belakang	penumpang	belakang	2
persawahan_belakang	persawahan	belakang	2
persoalan_belakangan	persoalan	belakangan	2
pertahanan_belakang	pertahanan	belakang	2
plastik_belakangan	plastik	belakangan	2
posisi_belakang	posisi	belakang	2
publik_belakangan	publik	belakangan	2
pun_belakangan	pun	belakangan	2
ruangan_belakang	ruangan	belakang	2
rumah_membelakangi	rumah	membelakangi	2
sama_belakangan	sama	belakangan	2
sambil_membelakangi	sambil	membelakangi	2
sampul_belakang	sampul	belakang	2
saraf_belakang	saraf	belakang	2
sayang_belakangan	sayang	belakangan	2
sebab_belakangan	sebab	belakangan	2
sebulan_belakangan	sebulan	belakangan	2
sekolah-sekolah_ter-kebelakang	sekolah-sekolah	ter-kebelakang	2
sepekan_belakangan	sepekan	belakangan	2
sosial_belakangan	sosial	belakangan	2
suspensi_belakang	suspensi	belakang	2
tahu_belakangan	tahu	belakangan	2
tahun_kebelakang	tahun	kebelakang	2
tampaknya_belakangan	tampaknya	belakangan	2
tampilan_belakang	tampilan	belakang	2
tepat_dibelakang	tepat	dibelakang	2
terjadi_belakang	terjadi	belakang	2
teror_belakangan	teror	belakangan	2
tinggi_belakangan	tinggi	belakangan	2
umat_belakangan	umat	belakangan	2
untuk_belakang	untuk	belakang	2
yang_melatarbelakanginya	yang	melatarbelakanginya	2
yang_terbelakang	yang	terbelakang	2
ada_dibelakangnya	ada	dibelakangnya	1
adiktif_belakangan	adiktif	belakangan	1
agak_kebelakang	agak	kebelakang	1
akibat_dibelakangnya	akibat	dibelakangnya	1
akik_belakangan	akik	belakangan	1
alergi_belakangan	alergi	belakangan	1
amat_terbelakang	amat	terbelakang	1
anak_belakangan	anak	belakangan	1
antartulang_belakang	antartulang	belakang	1
apapun_latarbelakang	apapun	latarbelakang	1
atau_keterbelakangan	atau	keterbelakangan	1
atau_maju-terbelakang	atau	maju-terbelakang	1
ataupun_belakang	ataupun	belakang	1
atlet_belakangan	atlet	belakangan	1
awalnya_dibelakang	awalnya	dibelakang	1
bagian_kanan-belakang	bagian	kanan-belakang	1
bagus_belakangan	bagus	belakangan	1
bahkan_belakangan	bahkan	belakangan	1
bale_belakang	bale	belakang	1
bangsa_belakangan	bangsa	belakangan	1
baris_belakang	baris	belakang	1
baru_belakangan	baru	belakangan	1
bawah_belakang	bawah	belakang	1
beba-tuan_belakang	beba-tuan	belakang	1
belakang_1920-an	belakang	1920-an	1
belakang_23MP	belakang	23MP	1
belakang_5MP	belakang	5MP	1
belakang_90-an	belakang	90-an	1
belakang_adanya	belakang	adanya	1
belakang_adat	belakang	adat	1
belakang_agak	belakang	agak	1
belakang_agamanya	belakang	agamanya	1
belakang_agen	belakang	agen	1
belakang_ahli	belakang	ahli	1
belakang_air	belakang	air	1
belakang_aja	belakang	aja	1
belakang_ajungan	belakang	ajungan	1
belakang_akademikus	belakang	akademikus	1
belakang_akademis	belakang	akademis	1
belakang_akademisi	belakang	akademisi	1
belakang_aktivis	belakang	aktivis	1
belakang_aku	belakang	aku	1
belakang_alangkah	belakang	alangkah	1
belakang_alasan	belakang	alasan	1
belakang_anak	belakang	anak	1
belakang_anda	belakang	anda	1
belakang_andalannya	belakang	andalannya	1
belakang_anggotanya	belakang	anggotanya	1
belakang_angka	belakang	angka	1
belakang_apa	belakang	apa	1
belakang_aplikasi	belakang	aplikasi	1
belakang_arah	belakang	arah	1
belakang_aspirasi	belakang	aspirasi	1
belakang_asrama	belakang	asrama	1
belakang_atas	belakang	atas	1
belakang_atlet	belakang	atlet	1
belakang_atlet-atlet	belakang	atlet-atlet	1
belakang_badan	belakang	badan	1
belakang_badannya	belakang	badannya	1
belakang_bagaimana	belakang	bagaimana	1
belakang_bahu	belakang	bahu	1
belakang_baik	belakang	baik	1
belakang_bakal	belakang	bakal	1
belakang_ban	belakang	ban	1
belakang_bandara	belakang	bandara	1
belakang_baru	belakang	baru	1
belakang_barulah	belakang	barulah	1
belakang_bebek	belakang	bebek	1
belakang_beberapa	belakang	beberapa	1
belakang_bek	belakang	bek	1
belakang_bela	belakang	bela	1
belakang_bench	belakang	bench	1
belakang_bendera	belakang	bendera	1
belakang_ber	belakang	ber	1
belakang_ber-beda	belakang	ber-beda	1
belakang_berarti	belakang	berarti	1
belakang_berbeda-beda	belakang	berbeda-beda	1
belakang_berfungsi	belakang	berfungsi	1
belakang_bergandengan	belakang	bergandengan	1
belakang_berkekuatan	belakang	berkekuatan	1
belakang_berkumpul	belakang	berkumpul	1
belakang_berlangsung	belakang	berlangsung	1
belakang_bermaterial	belakang	bermaterial	1
belakang_berpindahnya	belakang	berpindahnya	1
belakang_bersama	belakang	bersama	1
belakang_bertema	belakang	bertema	1
belakang_bertengger	belakang	bertengger	1
belakang_bertumpuk	belakang	bertumpuk	1
belakang_berubah	belakang	berubah	1
belakang_berujung	belakang	berujung	1
belakang_berwarna	belakang	berwarna	1
belakang_betawi	belakang	betawi	1
belakang_biro-krat	belakang	biro-krat	1
belakang_birunya	belakang	birunya	1
belakang_bodinya	belakang	bodinya	1
belakang_body	belakang	body	1
belakang_buang	belakang	buang	1
belakang_bukanlah	belakang	bukanlah	1
belakang_bukit-bukit	belakang	bukit-bukit	1
belakang_bunga	belakang	bunga	1
belakang_bunga‎	belakang	bunga‎	1
belakang_bus‎	belakang	bus‎	1
belakang_celah	belakang	celah	1
belakang_celaka	belakang	celaka	1
belakang_ceritanya	belakang	ceritanya	1
belakang_cokelat	belakang	cokelat	1
belakang_contohnya	belakang	contohnya	1
belakang_cover	belakang	cover	1
belakang_crane	belakang	crane	1
belakang_curah	belakang	curah	1
belakang_dangan	belakang	dangan	1
belakang_dapur	belakang	dapur	1
belakang_dayah	belakang	dayah	1
belakang_dekat	belakang	dekat	1
belakang_delapan	belakang	delapan	1
belakang_demikian	belakang	demikian	1
belakang_demografis	belakang	demografis	1
belakang_deng	belakang	deng	1
belakang_deretan	belakang	deretan	1
belakang_diadakannya	belakang	diadakannya	1
belakang_dianggap	belakang	dianggap	1
belakang_dibanding	belakang	dibanding	1
belakang_dibekali	belakang	dibekali	1
belakang_dibuka	belakang	dibuka	1
belakang_dicegah	belakang	dicegah	1
belakang_didirikannya	belakang	didirikannya	1
belakang_digadaikannya	belakang	digadaikannya	1
belakang_dige-larnya	belakang	dige-larnya	1
belakang_digital	belakang	digital	1
belakang_dijaga	belakang	dijaga	1
belakang_dikawal	belakang	dikawal	1
belakang_dikenakan	belakang	dikenakan	1
belakang_diketahui	belakang	diketahui	1
belakang_dilakukannya	belakang	dilakukannya	1
belakang_dilernya	belakang	dilernya	1
belakang_dinding	belakang	dinding	1
belakang_diperbaiki	belakang	diperbaiki	1
belakang_ditangkap	belakang	ditangkap	1
belakang_ditulis	belakang	ditulis	1
belakang_ditunjuknya	belakang	ditunjuknya	1
belakang_diwide	belakang	diwide	1
belakang_dog	belakang	dog	1
belakang_dong	belakang	dong	1
belakang_dosen	belakang	dosen	1
belakang_dual	belakang	dual	1
belakang_duet	belakang	duet	1
belakang_duo	belakang	duo	1
belakang_eko-nomi	belakang	eko-nomi	1
belakang_ekonom	belakang	ekonom	1
belakang_energi	belakang	energi	1
belakang_film-film	belakang	film-film	1
belakang_forum	belakang	forum	1
belakang_fosil	belakang	fosil	1
belakang_gambar	belakang	gambar	1
belakang_gang	belakang	gang	1
belakang_ganteng	belakang	ganteng	1
belakang_gendang	belakang	gendang	1
belakang_gender	belakang	gender	1
belakang_gerak	belakang	gerak	1
belakang_gugatannya	belakang	gugatannya	1
belakang_gunungan	belakang	gunungan	1
belakang_halte	belakang	halte	1
belakang_hancur	belakang	hancur	1
belakang_helm	belakang	helm	1
belakang_historikal	belakang	historikal	1
belakang_historis	belakang	historis	1
belakang_hu-kum	belakang	hu-kum	1
belakang_hukum	belakang	hukum	1
belakang_huruf	belakang	huruf	1
belakang_hutang	belakang	hutang	1
belakang_ia	belakang	ia	1
belakang_ibu	belakang	ibu	1
belakang_ide-ide	belakang	ide-ide	1
belakang_ideologis	belakang	ideologis	1
belakang_ihwal	belakang	ihwal	1
belakang_ilmunya	belakang	ilmunya	1
belakang_imam	belakang	imam	1
belakang_imperialis	belakang	imperialis	1
belakang_inci	belakang	inci	1
belakang_industri	belakang	industri	1
belakang_intelijen	belakang	intelijen	1
belakang_intensi	belakang	intensi	1
belakang_iPhone	belakang	iPhone	1
belakang_iring-iringan	belakang	iring-iringan	1
belakang_istrinya	belakang	istrinya	1
belakang_jajaran	belakang	jajaran	1
belakang_jakun	belakang	jakun	1
belakang_jamaah	belakang	jamaah	1
belakang_jas	belakang	jas	1
belakang_jauh	belakang	jauh	1
belakang_jelasnya	belakang	jelasnya	1
belakang_jika	belakang	jika	1
belakang_jok	belakang	jok	1
belakang_jumbo	belakang	jumbo	1
belakang_jurnalistik	belakang	jurnalistik	1
belakang_juru	belakang	juru	1
belakang_kabinet	belakang	kabinet	1
belakang_kaca	belakang	kaca	1
belakang_kaget	belakang	kaget	1
belakang_kakek	belakang	kakek	1
belakang_kampung	belakang	kampung	1
belakang_kanan	belakang	kanan	1
belakang_kapak	belakang	kapak	1
belakang_karakter	belakang	karakter	1
belakang_karir	belakang	karir	1
belakang_karirnya	belakang	karirnya	1
belakang_kartu	belakang	kartu	1
belakang_karyawati	belakang	karyawati	1
belakang_kasir	belakang	kasir	1
belakang_kasus	belakang	kasus	1
belakang_kaum	belakang	kaum	1
belakang_kaus	belakang	kaus	1
belakang_kawa-san	belakang	kawa-san	1
belakang_ke-jahatan	belakang	ke-jahatan	1
belakang_kebencian	belakang	kebencian	1
belakang_kebijakan	belakang	kebijakan	1
belakang_kebun	belakang	kebun	1
belakang_kedekatan	belakang	kedekatan	1
belakang_kehi-dupan	belakang	kehi-dupan	1
belakang_keindahan	belakang	keindahan	1
belakang_kekotaan	belakang	kekotaan	1
belakang_kelihatan	belakang	kelihatan	1
belakang_keluh	belakang	keluh	1
belakang_kematian	belakang	kematian	1
belakang_kembali	belakang	kembali	1
belakang_kemenangannya	belakang	kemenangannya	1
belakang_kenapa	belakang	kenapa	1
belakang_kenda-raan	belakang	kenda-raan	1
belakang_kendaran	belakang	kendaran	1
belakang_kentut	belakang	kentut	1
belakang_kepalaku	belakang	kepalaku	1
belakang_kepemimpinan	belakang	kepemimpinan	1
belakang_keputusan	belakang	keputusan	1
belakang_kerabat	belakang	kerabat	1
belakang_keraton	belakang	keraton	1
belakang_kerusuhan	belakang	kerusuhan	1
belakang_kesukuan	belakang	kesukuan	1
belakang_keterlibatan	belakang	keterlibatan	1
belakang_ketiga	belakang	ketiga	1
belakang_kewila-yahan	belakang	kewila-yahan	1
belakang_keyakinan	belakang	keyakinan	1
belakang_khusus	belakang	khusus	1
belakang_khususnya	belakang	khususnya	1
belakang_kios-kios	belakang	kios-kios	1
belakang_kipas	belakang	kipas	1
belakang_klasik	belakang	klasik	1
belakang_knalpot	belakang	knalpot	1
belakang_kolase	belakang	kolase	1
belakang_komputer	belakang	komputer	1
belakang_kontraktor	belakang	kontraktor	1
belakang_korslet	belakang	korslet	1
belakang_kota	belakang	kota	1
belakang_kriminal	belakang	kriminal	1
belakang_kuasa	belakang	kuasa	1
belakang_kuda	belakang	kuda	1
belakang_kuliah	belakang	kuliah	1
belakang_kuliner	belakang	kuliner	1
belakang_kunci	belakang	kunci	1
belakang_kuping	belakang	kuping	1
belakang_kurang	belakang	kurang	1
belakang_la-wan	belakang	la-wan	1
belakang_la-yar	belakang	la-yar	1
belakang_lalu	belakang	lalu	1
belakang_lampu	belakang	lampu	1
belakang_laptop	belakang	laptop	1
belakang_laut	belakang	laut	1
belakang_leher	belakang	leher	1
belakang_lensa	belakang	lensa	1
belakang_litologi	belakang	litologi	1
belakang_lulusan	belakang	lulusan	1
belakang_lumbar	belakang	lumbar	1
belakang_lupa	belakang	lupa	1
belakang_makamnya	belakang	makamnya	1
belakang_mal	belakang	mal	1
belakang_malah	belakang	malah	1
belakang_mampu	belakang	mampu	1
belakang_manusia	belakang	manusia	1
belakang_mapolres	belakang	mapolres	1
belakang_masa	belakang	masa	1
belakang_masya	belakang	masya	1
belakang_masyarakat	belakang	masyarakat	1
belakang_melainkan	belakang	melainkan	1
belakang_melaju	belakang	melaju	1
belakang_melakukan	belakang	melakukan	1
belakang_meletus	belakang	meletus	1
belakang_memainkan	belakang	memainkan	1
belakang_memakai	belakang	memakai	1
belakang_memaksa	belakang	memaksa	1
belakang_memangkas	belakang	memangkas	1
belakang_memastikan	belakang	memastikan	1
belakang_membantu	belakang	membantu	1
belakang_membentuk	belakang	membentuk	1
belakang_memeriksa	belakang	memeriksa	1
belakang_memiliki	belakang	memiliki	1
belakang_menangani	belakang	menangani	1
belakang_mencari	belakang	mencari	1
belakang_mendadak	belakang	mendadak	1
belakang_menegaskan	belakang	menegaskan	1
belakang_menemani	belakang	menemani	1
belakang_mengakui	belakang	mengakui	1
belakang_mengawal	belakang	mengawal	1
belakang_mengecewakan	belakang	mengecewakan	1
belakang_menghadap	belakang	menghadap	1
belakang_mengingat	belakang	mengingat	1
belakang_menimbulkan	belakang	menimbulkan	1
belakang_menjadikan	belakang	menjadikan	1
belakang_menteri	belakang	menteri	1
belakang_menuju	belakang	menuju	1
belakang_menumpu	belakang	menumpu	1
belakang_menunjukkan	belakang	menunjukkan	1
belakang_menurutnya	belakang	menurutnya	1
belakang_menyebut	belakang	menyebut	1
belakang_menyenggolnya	belakang	menyenggolnya	1
belakang_menyentuh	belakang	menyentuh	1
belakang_menyusul	belakang	menyusul	1
belakang_merayakan	belakang	merayakan	1
belakang_merepresentasikan	belakang	merepresentasikan	1
belakang_merupakan	belakang	merupakan	1
belakang_meski	belakang	meski	1
belakang_mikrofon	belakang	mikrofon	1
belakang_militernya	belakang	militernya	1
belakang_mirip	belakang	mirip	1
belakang_mo-bil	belakang	mo-bil	1
belakang_monitor	belakang	monitor	1
belakang_monoshock	belakang	monoshock	1
belakang_moratorium	belakang	moratorium	1
belakang_motornya	belakang	motornya	1
belakang_mudah	belakang	mudah	1
belakang_multietnis	belakang	multietnis	1
belakang_mungkin	belakang	mungkin	1
belakang_museum	belakang	museum	1
belakang_musik	belakang	musik	1
belakang_namanya	belakang	namanya	1
belakang_nampan	belakang	nampan	1
belakang_namun	belakang	namun	1
belakang_ne-gara	belakang	ne-gara	1
belakang_ngasih	belakang	ngasih	1
belakang_notebook	belakang	notebook	1
belakang_novel	belakang	novel	1
belakang_objek	belakang	objek	1
belakang_olah	belakang	olah	1
belakang_optimisme	belakang	optimisme	1
belakang_orangnya	belakang	orangnya	1
belakang_otak	belakang	otak	1
belakang_pa	belakang	pa	1
belakang_paha	belakang	paha	1
belakang_pahanya	belakang	pahanya	1
belakang_pameran	belakang	pameran	1
belakang_panel	belakang	panel	1
belakang_pang-gung	belakang	pang-gung	1
belakang_panorama	belakang	panorama	1
belakang_pantai	belakang	pantai	1
belakang_parkir	belakang	parkir	1
belakang_partai	belakang	partai	1
belakang_pasti	belakang	pasti	1
belakang_pe-nentuan	belakang	pe-nentuan	1
belakang_pecah	belakang	pecah	1
belakang_pejabat	belakang	pejabat	1
belakang_peker-jaan	belakang	peker-jaan	1
belakang_pekerjaannya	belakang	pekerjaannya	1
belakang_peledakan	belakang	peledakan	1
belakang_pembentukan	belakang	pembentukan	1
belakang_pemecatannya	belakang	pemecatannya	1
belakang_pementasan	belakang	pementasan	1
belakang_pemerintah	belakang	pemerintah	1
belakang_pemerintahan	belakang	pemerintahan	1
belakang_pemesan	belakang	pemesan	1
belakang_pemilihan	belakang	pemilihan	1
belakang_pemimpin	belakang	pemimpin	1
belakang_pemimpinnya	belakang	pemimpinnya	1
belakang_pemkot	belakang	pemkot	1
belakang_pemuncak	belakang	pemuncak	1
belakang_pen	belakang	pen	1
belakang_penampilan	belakang	penampilan	1
belakang_pencatatan	belakang	pencatatan	1
belakang_penciptaan	belakang	penciptaan	1
belakang_pendeta	belakang	pendeta	1
belakang_pendi-dikan	belakang	pendi-dikan	1
belakang_pendidi-kan	belakang	pendidi-kan	1
belakang_pendirian	belakang	pendirian	1
belakang_pendukung	belakang	pendukung	1
belakang_penetapannya	belakang	penetapannya	1
belakang_pengadaan	belakang	pengadaan	1
belakang_pengembangan	belakang	pengembangan	1
belakang_pengemudinya	belakang	pengemudinya	1
belakang_pengendara	belakang	pengendara	1
belakang_pengetahuan	belakang	pengetahuan	1
belakang_pengguna	belakang	pengguna	1
belakang_penghapusan	belakang	penghapusan	1
belakang_penghuni	belakang	penghuni	1
belakang_pengurus	belakang	pengurus	1
belakang_penindasan	belakang	penindasan	1
belakang_penista	belakang	penista	1
belakang_penonton	belakang	penonton	1
belakang_penulis	belakang	penulis	1
belakang_penulisan	belakang	penulisan	1
belakang_penyebab	belakang	penyebab	1
belakang_penyebabnya	belakang	penyebabnya	1
belakang_penyebutan	belakang	penyebutan	1
belakang_penyidik	belakang	penyidik	1
belakang_penyok	belakang	penyok	1
belakang_perangkat	belakang	perangkat	1
belakang_pergelangan	belakang	pergelangan	1
belakang_pergolakan	belakang	pergolakan	1
belakang_peristiwa	belakang	peristiwa	1
belakang_peritiwa	belakang	peritiwa	1
belakang_permai-nan	belakang	permai-nan	1
belakang_pernah	belakang	pernah	1
belakang_pernikahan	belakang	pernikahan	1
belakang_perpe-cahan	belakang	perpe-cahan	1
belakang_perpecahan	belakang	perpecahan	1
belakang_persoalan	belakang	persoalan	1
belakang_pertahanan	belakang	pertahanan	1
belakang_pertan-dingan	belakang	pertan-dingan	1
belakang_pertandi-ngan	belakang	pertandi-ngan	1
belakang_pertanian	belakang	pertanian	1
belakang_pertemuan	belakang	pertemuan	1
belakang_petani	belakang	petani	1
belakang_pin-jaman	belakang	pin-jaman	1
belakang_planet	belakang	planet	1
belakang_pohon	belakang	pohon	1
belakang_pohon-po-hon	belakang	pohon-po-hon	1
belakang_pola	belakang	pola	1
belakang_polisi	belakang	polisi	1
belakang_ponsel	belakang	ponsel	1
belakang_pos	belakang	pos	1
belakang_praktisi	belakang	praktisi	1
belakang_presiden	belakang	presiden	1
belakang_prestasi	belakang	prestasi	1
belakang_pria	belakang	pria	1
belakang_proarm	belakang	proarm	1
belakang_profesional	belakang	profesional	1
belakang_proses	belakang	proses	1
belakang_punggung	belakang	punggung	1
belakang_punggungnya	belakang	punggungnya	1
belakang_pungkasnya	belakang	pungkasnya	1
belakang_putarannya	belakang	putarannya	1
belakang_rahang	belakang	rahang	1
belakang_raja	belakang	raja	1
belakang_rajut	belakang	rajut	1
belakang_ras	belakang	ras	1
belakang_real	belakang	real	1
belakang_rekam	belakang	rekam	1
belakang_rekan	belakang	rekan	1
belakang_rekomendasi	belakang	rekomendasi	1
belakang_religi	belakang	religi	1
belakang_religiusitas	belakang	religiusitas	1
belakang_restoran	belakang	restoran	1
belakang_revisi	belakang	revisi	1
belakang_rider	belakang	rider	1
belakang_rivalnya	belakang	rivalnya	1
belakang_ruangan	belakang	ruangan	1
belakang_ruko	belakang	ruko	1
belakang_rumah-nya	belakang	rumah-nya	1
belakang_rusun	belakang	rusun	1
belakang_safety	belakang	safety	1
belakang_sahutnya	belakang	sahutnya	1
belakang_salju	belakang	salju	1
belakang_salon	belakang	salon	1
belakang_sambut	belakang	sambut	1
belakang_samping	belakang	samping	1
belakang_sar-jana	belakang	sar-jana	1
belakang_sarjana	belakang	sarjana	1
belakang_sasana	belakang	sasana	1
belakang_se-hingga	belakang	se-hingga	1
belakang_seakan	belakang	seakan	1
belakang_seakan-akan	belakang	seakan-akan	1
belakang_sebaiknya	belakang	sebaiknya	1
belakang_sebelumnya	belakang	sebelumnya	1
belakang_sebenarnya	belakang	sebenarnya	1
belakang_sedang	belakang	sedang	1
belakang_sedangkan	belakang	sedangkan	1
belakang_sedikit	belakang	sedikit	1
belakang_sehing-ga	belakang	sehing-ga	1
belakang_sejauh	belakang	sejauh	1
belakang_sekaligus	belakang	sekaligus	1
belakang_sekarang	belakang	sekarang	1
belakang_sekolahnya	belakang	sekolahnya	1
belakang_sel	belakang	sel	1
belakang_selalu	belakang	selalu	1
belakang_semen-tara	belakang	semen-tara	1
belakang_seni	belakang	seni	1
belakang_seragam	belakang	seragam	1
belakang_sesekali	belakang	sesekali	1
belakang_seseorang	belakang	seseorang	1
belakang_sewaktu	belakang	sewaktu	1
belakang_si	belakang	si	1
belakang_sinergi	belakang	sinergi	1
belakang_sirih	belakang	sirih	1
belakang_siswa	belakang	siswa	1
belakang_siswanya	belakang	siswanya	1
belakang_skuadnya	belakang	skuadnya	1
belakang_smart	belakang	smart	1
belakang_so	belakang	so	1
belakang_soal	belakang	soal	1
belakang_soalnya	belakang	soalnya	1
belakang_sosiologis	belakang	sosiologis	1
belakang_suara	belakang	suara	1
belakang_supermarket	belakang	supermarket	1
belakang_tabung	belakang	tabung	1
belakang_tahun	belakang	tahun	1
belakang_tampak	belakang	tampak	1
belakang_tanaman	belakang	tanaman	1
belakang_tandas	belakang	tandas	1
belakang_tari	belakang	tari	1
belakang_tata	belakang	tata	1
belakang_tayangan	belakang	tayangan	1
belakang_tegas	belakang	tegas	1
belakang_teknik	belakang	teknik	1
belakang_teknologi	belakang	teknologi	1
belakang_tengkorak	belakang	tengkorak	1
belakang_tentang	belakang	tentang	1
belakang_tentara	belakang	tentara	1
belakang_teraba	belakang	teraba	1
belakang_terbuka	belakang	terbuka	1
belakang_terdengar	belakang	terdengar	1
belakang_terdiri	belakang	terdiri	1
belakang_terhadap	belakang	terhadap	1
belakang_terjatuh	belakang	terjatuh	1
belakang_terkadang	belakang	terkadang	1
belakang_terkena	belakang	terkena	1
belakang_terlalu	belakang	terlalu	1
belakang_terlebih	belakang	terlebih	1
belakang_terlempar	belakang	terlempar	1
belakang_termasuk	belakang	termasuk	1
belakang_tersemat	belakang	tersemat	1
belakang_tertulis	belakang	tertulis	1
belakang_tetap	belakang	tetap	1
belakang_tewasnya	belakang	tewasnya	1
belakang_tiang	belakang	tiang	1
belakang_tiap	belakang	tiap	1
belakang_tiba-tiba	belakang	tiba-tiba	1
belakang_tindakan	belakang	tindakan	1
belakang_tirai	belakang	tirai	1
belakang_truck	belakang	truck	1
belakang_tubuh	belakang	tubuh	1
belakang_tudingan	belakang	tudingan	1
belakang_tulisan	belakang	tulisan	1
belakang_tumit	belakang	tumit	1
belakang_tutur	belakang	tutur	1
belakang_tuturnya	belakang	tuturnya	1
belakang_uang	belakang	uang	1
belakang_ucap	belakang	ucap	1
belakang_ulama	belakang	ulama	1
belakang_ungkap	belakang	ungkap	1
belakang_ungkapnya	belakang	ungkapnya	1
belakang_unik	belakang	unik	1
belakang_unit	belakang	unit	1
belakang_upaya	belakang	upaya	1
belakang_usaha	belakang	usaha	1
belakang_usahanya	belakang	usahanya	1
belakang_utama	belakang	utama	1
belakang_utara	belakang	utara	1
belakang_via	belakang	via	1
belakang_vila	belakang	vila	1
belakang_visi	belakang	visi	1
belakang_voucher	belakang	voucher	1
belakang_vulkanisir	belakang	vulkanisir	1
belakang_w	belakang	w	1
belakang_waduk	belakang	waduk	1
belakang_waruga	belakang	waruga	1
belakang_wasit	belakang	wasit	1
belakang_wisudawan	belakang	wisudawan	1
belakang_yaitu	belakang	yaitu	1
belakang_zaman	belakang	zaman	1
belakang-an_diakibatkan	belakang-an	diakibatkan	1
belakang-an_disikapi	belakang-an	disikapi	1
belakang-membelakangi_tetapi	belakang-membelakangi	tetapi	1
belakang-nya_jelas	belakang-nya	jelas	1
belakang-nya_tandasnya	belakang-nya	tandasnya	1
belakangan_agak	belakangan	agak	1
belakangan_aja	belakangan	aja	1
belakangan_akan	belakangan	akan	1
belakangan_akhirnya	belakangan	akhirnya	1
belakangan_akibat	belakangan	akibat	1
belakangan_aksinya	belakangan	aksinya	1
belakangan_anak-anak	belakangan	anak-anak	1
belakangan_anggap-an	belakangan	anggap-an	1
belakangan_angka	belakangan	angka	1
belakangan_bantuan	belakangan	bantuan	1
belakangan_baru	belakangan	baru	1
belakangan_batal	belakangan	batal	1
belakangan_begitu	belakangan	begitu	1
belakangan_berada	belakangan	berada	1
belakangan_berarti	belakangan	berarti	1
belakangan_berembus	belakangan	berembus	1
belakangan_bergabung	belakangan	bergabung	1
belakangan_berjuang	belakangan	berjuang	1
belakangan_berkata	belakangan	berkata	1
belakangan_berlangsung	belakangan	berlangsung	1
belakangan_bernama	belakangan	bernama	1
belakangan_bertujuan	belakangan	bertujuan	1
belakangan_bukan	belakangan	bukan	1
belakangan_calon	belakangan	calon	1
belakangan_citra	belakangan	citra	1
belakangan_cukup	belakangan	cukup	1
belakangan_de-ngan	belakangan	de-ngan	1
belakangan_demam	belakangan	demam	1
belakangan_deretan	belakangan	deretan	1
belakangan_diakui	belakangan	diakui	1
belakangan_dibanding	belakangan	dibanding	1
belakangan_dibebaskan	belakangan	dibebaskan	1
belakangan_dibenarkan	belakangan	dibenarkan	1
belakangan_dibunuh	belakangan	dibunuh	1
belakangan_dielus	belakangan	dielus	1
belakangan_digadang-gadang	belakangan	digadang-gadang	1
belakangan_digeser	belakangan	digeser	1
belakangan_dihebohkan	belakangan	dihebohkan	1
belakangan_diikuti	belakangan	diikuti	1
belakangan_dika-barkan	belakangan	dika-barkan	1
belakangan_dikabarkan	belakangan	dikabarkan	1
belakangan_dikaitkan	belakangan	dikaitkan	1
belakangan_dikatakan	belakangan	dikatakan	1
belakangan_dikenal	belakangan	dikenal	1
belakangan_dikhawatirkan	belakangan	dikhawatirkan	1
belakangan_dikritik	belakangan	dikritik	1
belakangan_dimana	belakangan	dimana	1
belakangan_dinamika	belakangan	dinamika	1
belakangan_dipakai	belakangan	dipakai	1
belakangan_dipanggil	belakangan	dipanggil	1
belakangan_dipersoalkan	belakangan	dipersoalkan	1
belakangan_dipertanyakan	belakangan	dipertanyakan	1
belakangan_dirinya	belakangan	dirinya	1
belakangan_disesaki	belakangan	disesaki	1
belakangan_disikapinya	belakangan	disikapinya	1
belakangan_disinyalir	belakangan	disinyalir	1
belakangan_ditam-pik	belakangan	ditam-pik	1
belakangan_ditemukan	belakangan	ditemukan	1
belakangan_ditepis	belakangan	ditepis	1
belakangan_ditetap-kan	belakangan	ditetap-kan	1
belakangan_ditetapkan	belakangan	ditetapkan	1
belakangan_dituduh	belakangan	dituduh	1
belakangan_dokter	belakangan	dokter	1
belakangan_dr	belakangan	dr	1
belakangan_enggan	belakangan	enggan	1
belakangan_gelombang	belakangan	gelombang	1
belakangan_gra	belakangan	gra	1
belakangan_hal	belakangan	hal	1
belakangan_hampir	belakangan	hampir	1
belakangan_hanyalah	belakangan	hanyalah	1
belakangan_helatan	belakangan	helatan	1
belakangan_ibu	belakangan	ibu	1
belakangan_identik	belakangan	identik	1
belakangan_ingat	belakangan	ingat	1
belakangan_inilah	belakangan	inilah	1
belakangan_intens	belakangan	intens	1
belakangan_jadwal	belakangan	jadwal	1
belakangan_jarang	belakangan	jarang	1
belakangan_jatuh	belakangan	jatuh	1
belakangan_jelas	belakangan	jelas	1
belakangan_jumlah	belakangan	jumlah	1
belakangan_kami	belakangan	kami	1
belakangan_ke	belakangan	ke	1
belakangan_kebutuhan	belakangan	kebutuhan	1
belakangan_kegiatannya	belakangan	kegiatannya	1
belakangan_kelompok	belakangan	kelompok	1
belakangan_kem-bali	belakangan	kem-bali	1
belakangan_kembali	belakangan	kembali	1
belakangan_kendati	belakangan	kendati	1
belakangan_keputusan	belakangan	keputusan	1
belakangan_ketera-ngannya	belakangan	ketera-ngannya	1
belakangan_keunggulan	belakangan	keunggulan	1
belakangan_khususnya	belakangan	khususnya	1
belakangan_kita	belakangan	kita	1
belakangan_konser	belakangan	konser	1
belakangan_korban	belakangan	korban	1
belakangan_lampu	belakangan	lampu	1
belakangan_lembaga-lembaga	belakangan	lembaga-lembaga	1
belakangan_logam	belakangan	logam	1
belakangan_lumayan	belakangan	lumayan	1
belakangan_ma-kin	belakangan	ma-kin	1
belakangan_mahir	belakangan	mahir	1
belakangan_masa	belakangan	masa	1
belakangan_masalah	belakangan	masalah	1
belakangan_masyarakat	belakangan	masyarakat	1
belakangan_me-munculkan	belakangan	me-munculkan	1
belakangan_meicu	belakangan	meicu	1
belakangan_melawan	belakangan	melawan	1
belakangan_melejit	belakangan	melejit	1
belakangan_membawa	belakangan	membawa	1
belakangan_membentuk	belakangan	membentuk	1
belakangan_memicu	belakangan	memicu	1
belakangan_mempercepat	belakangan	mempercepat	1
belakangan_memulai	belakangan	memulai	1
belakangan_memunculkan	belakangan	memunculkan	1
belakangan_menambah	belakangan	menambah	1
belakangan_menanjak	belakangan	menanjak	1
belakangan_menarik	belakangan	menarik	1
belakangan_mencuat	belakangan	mencuat	1
belakangan_mendirikan	belakangan	mendirikan	1
belakangan_mengacu	belakangan	mengacu	1
belakangan_mengakibatkan	belakangan	mengakibatkan	1
belakangan_mengeluarkan	belakangan	mengeluarkan	1
belakangan_menghebohkan	belakangan	menghebohkan	1
belakangan_menimbul-kan	belakangan	menimbul-kan	1
belakangan_menimbulkan	belakangan	menimbulkan	1
belakangan_menjauhi	belakangan	menjauhi	1
belakangan_menjelang	belakangan	menjelang	1
belakangan_menurut	belakangan	menurut	1
belakangan_meragukan	belakangan	meragukan	1
belakangan_meski	belakangan	meski	1
belakangan_mesti	belakangan	mesti	1
belakangan_mewabah	belakangan	mewabah	1
belakangan_mobil	belakangan	mobil	1
belakangan_mu-lai	belakangan	mu-lai	1
belakangan_mun-cul	belakangan	mun-cul	1
belakangan_oleh	belakangan	oleh	1
belakangan_ormas-ormas	belakangan	ormas-ormas	1
belakangan_pada	belakangan	pada	1
belakangan_paling	belakangan	paling	1
belakangan_parpol	belakangan	parpol	1
belakangan_pasokan	belakangan	pasokan	1
belakangan_pelayan-an	belakangan	pelayan-an	1
belakangan_pemanfaatannya	belakangan	pemanfaatannya	1
belakangan_pembeli	belakangan	pembeli	1
belakangan_peme-nang	belakangan	peme-nang	1
belakangan_pemilik	belakangan	pemilik	1
belakangan_penampilannya	belakangan	penampilannya	1
belakangan_pengadaan	belakangan	pengadaan	1
belakangan_penjaga	belakangan	penjaga	1
belakangan_penyerang	belakangan	penyerang	1
belakangan_perannya	belakangan	perannya	1
belakangan_perbuatan	belakangan	perbuatan	1
belakangan_permo-honan	belakangan	permo-honan	1
belakangan_petugas	belakangan	petugas	1
belakangan_pihaknya	belakangan	pihaknya	1
belakangan_produk	belakangan	produk	1
belakangan_pungkasnya	belakangan	pungkasnya	1
belakangan_punya	belakangan	punya	1
belakangan_raksasa	belakangan	raksasa	1
belakangan_redup	belakangan	redup	1
belakangan_rela	belakangan	rela	1
belakangan_revisinya	belakangan	revisinya	1
belakangan_ribut	belakangan	ribut	1
belakangan_rumah	belakangan	rumah	1
belakangan_saat	belakangan	saat	1
belakangan_se-jumlah	belakangan	se-jumlah	1
belakangan_se-makin	belakangan	se-makin	1
belakangan_sebelum	belakangan	sebelum	1
belakangan_secepat	belakangan	secepat	1
belakangan_sedang	belakangan	sedang	1
belakangan_sejum-lah	belakangan	sejum-lah	1
belakangan_sejumlah	belakangan	sejumlah	1
belakangan_selepas	belakangan	selepas	1
belakangan_serangan	belakangan	serangan	1
belakangan_sosisalisasi	belakangan	sosisalisasi	1
belakangan_tahan	belakangan	tahan	1
belakangan_tahu	belakangan	tahu	1
belakangan_tampil	belakangan	tampil	1
belakangan_tanaman	belakangan	tanaman	1
belakangan_tapi	belakangan	tapi	1
belakangan_tengah	belakangan	tengah	1
belakangan_terbukti	belakangan	terbukti	1
belakangan_tergugat	belakangan	tergugat	1
belakangan_terhitung	belakangan	terhitung	1
belakangan_terkait	belakangan	terkait	1
belakangan_terkenal	belakangan	terkenal	1
belakangan_terkesan	belakangan	terkesan	1
belakangan_terkuak	belakangan	terkuak	1
belakangan_terlibat	belakangan	terlibat	1
belakangan_tetap	belakangan	tetap	1
belakangan_tim	belakangan	tim	1
belakangan_tinggi	belakangan	tinggi	1
belakangan_tingkat	belakangan	tingkat	1
belakangan_tokoh	belakangan	tokoh	1
belakangan_tradisi	belakangan	tradisi	1
belakangan_ungkapnya	belakangan	ungkapnya	1
belakangan_unit	belakangan	unit	1
belakangan_untuk	belakangan	untuk	1
belakangan_usulannya	belakangan	usulannya	1
belakangan_virus	belakangan	virus	1
belakangan_warga	belakangan	warga	1
belakangan_ya	belakangan	ya	1
belakangan_yakni	belakangan	yakni	1
belakangi_kasus	belakangi	kasus	1
belakangi_keyakinan	belakangi	keyakinan	1
belakangi_oleh	belakangi	oleh	1
belakangi_olehbeberapa	belakangi	olehbeberapa	1
belakangku_ada	belakangku	ada	1
belakangmu_berdarah	belakangmu	berdarah	1
belakangnja_akan	belakangnja	akan	1
belakangnja_karena	belakangnja	karena	1
belakangnya_agar	belakangnya	agar	1
belakangnya_ahli	belakangnya	ahli	1
belakangnya_akan	belakangnya	akan	1
belakangnya_apakah	belakangnya	apakah	1
belakangnya_berbaris	belakangnya	berbaris	1
belakangnya_berbentuk	belakangnya	berbentuk	1
belakangnya_bukan	belakangnya	bukan	1
belakangnya_cukup	belakangnya	cukup	1
belakangnya_diambil	belakangnya	diambil	1
belakangnya_didisain	belakangnya	didisain	1
belakangnya_digunakan	belakangnya	digunakan	1
belakangnya_hingga	belakangnya	hingga	1
belakangnya_hinterland	belakangnya	hinterland	1
belakangnya_ialah	belakangnya	ialah	1
belakangnya_jelasnya	belakangnya	jelasnya	1
belakangnya_kaget	belakangnya	kaget	1
belakangnya_kalau	belakangnya	kalau	1
belakangnya_karena	belakangnya	karena	1
belakangnya_katanya	belakangnya	katanya	1
belakangnya_kelahiran	belakangnya	kelahiran	1
belakangnya_kelam	belakangnya	kelam	1
belakangnya_lan-taran	belakangnya	lan-taran	1
belakangnya_lebih	belakangnya	lebih	1
belakangnya_mampu	belakangnya	mampu	1
belakangnya_masih	belakangnya	masih	1
belakangnya_melihat	belakangnya	melihat	1
belakangnya_membuang	belakangnya	membuang	1
belakangnya_memungkinkan	belakangnya	memungkinkan	1
belakangnya_menginjak	belakangnya	menginjak	1
belakangnya_menyusul	belakangnya	menyusul	1
belakangnya_mereka	belakangnya	mereka	1
belakangnya_mobil	belakangnya	mobil	1
belakangnya_nampak	belakangnya	nampak	1
belakangnya_namun	belakangnya	namun	1
belakangnya_nyaris	belakangnya	nyaris	1
belakangnya_papar	belakangnya	papar	1
belakangnya_patah	belakangnya	patah	1
belakangnya_pembeli	belakangnya	pembeli	1
belakangnya_perairan	belakangnya	perairan	1
belakangnya_pernah	belakangnya	pernah	1
belakangnya_persis	belakangnya	persis	1
belakangnya_pungkas	belakangnya	pungkas	1
belakangnya_rombongan	belakangnya	rombongan	1
belakangnya_saat	belakangnya	saat	1
belakangnya_sangat	belakangnya	sangat	1
belakangnya_sedangkan	belakangnya	sedangkan	1
belakangnya_seperti	belakangnya	seperti	1
belakangnya_sepi	belakangnya	sepi	1
belakangnya_serupa	belakangnya	serupa	1
belakangnya_setelah	belakangnya	setelah	1
belakangnya_syarat-syarat	belakangnya	syarat-syarat	1
belakangnya_tampak	belakangnya	tampak	1
belakangnya_tentu	belakangnya	tentu	1
belakangnya_terdapat	belakangnya	terdapat	1
belakangnya_terhampar	belakangnya	terhampar	1
belakangnya_terlalu	belakangnya	terlalu	1
belakangnya_tertempel	belakangnya	tertempel	1
belakangnya_tetap	belakangnya	tetap	1
belakangnya_tiba-tiba	belakangnya	tiba-tiba	1
belakangnya_tu-kasnya	belakangnya	tu-kasnya	1
belakangnya_turut	belakangnya	turut	1
belakangnya_ujar	belakangnya	ujar	1
belakangnya_untuk	belakangnya	untuk	1
belakangnya_ya	belakangnya	ya	1
belatar_belakang	belatar	belakang	1
belukar_belakang	belukar	belakang	1
ber-kembang_belakangan	ber-kembang	belakangan	1
berada_dibelakangnya	berada	dibelakangnya	1
berangkat_belakangan	berangkat	belakangan	1
beras_belakangan	beras	belakangan	1
berbagai_latarbelakang	berbagai	latarbelakang	1
berbahaya_melatarbelakangi	berbahaya	melatarbelakangi	1
berbalik_belakang	berbalik	belakang	1
berbelit-belit_belakangan	berbelit-belit	belakangan	1
berdiri_dibelakang	berdiri	dibelakang	1
berdiri_membelakangi	berdiri	membelakangi	1
berga-bung_belakangan	berga-bung	belakangan	1
berhasil_belakangan	berhasil	belakangan	1
berkurang_belakangan	berkurang	belakangan	1
berla-tar_belakang	berla-tar	belakang	1
berlatar_belakangan	berlatar	belakangan	1
berlatar-belakang_profesi	berlatar-belakang	profesi	1
berlatarbelakang_budaya	berlatarbelakang	budaya	1
berlatarbelakang_dokter	berlatarbelakang	dokter	1
berlatarbelakang_jurnalistik	berlatarbelakang	jurnalistik	1
berlatarbelakang_lokalitas	berlatarbelakang	lokalitas	1
berlatarbelakang_masyarakat	berlatarbelakang	masyarakat	1
berlatarbelakang_militer	berlatarbelakang	militer	1
berlatarbelakang_pada	berlatarbelakang	pada	1
berlatarbelakang_pro-fesi	berlatarbelakang	pro-fesi	1
bermain_dibelakang	bermain	dibelakang	1
bermodalkan_latarbelakang	bermodalkan	latarbelakang	1
berpaling_membelakang	berpaling	membelakang	1
bersikeras_belakangan	bersikeras	belakangan	1
bertebaran_belakangan	bertebaran	belakangan	1
berto-lak_belakang	berto-lak	belakang	1
bertolak_belakangan	bertolak	belakangan	1
berwirausaha_dilatarbelakangi	berwirausaha	dilatarbelakangi	1
berwisata_belakangan	berwisata	belakangan	1
besar_berlatar-belakang	besar	berlatar-belakang	1
besar_berlatarbelakang	besar	berlatarbelakang	1
besarnya_belakangan	besarnya	belakangan	1
betis_belakangnya	betis	belakangnya	1
biasa_belakangan	biasa	belakangan	1
biasa_melatarbelakangi	biasa	melatarbelakangi	1
bicara_dibelakang	bicara	dibelakang	1
bisa_belakangan	bisa	belakangan	1
bisa_melatarbelakangi	bisa	melatarbelakangi	1
bodi_belakang	bodi	belakang	1
bodi_belakangnya	bodi	belakangnya	1
bodong_belakangan	bodong	belakangan	1
body_belakangnya	body	belakangnya	1
bola_belakang	bola	belakang	1
bola-bola_belakang	bola-bola	belakang	1
brtolak_belakang	brtolak	belakang	1
buah_dibelakangnya	buah	dibelakangnya	1
bukan_dilatarbelakangi	bukan	dilatarbelakangi	1
bulan_belakang	bulan	belakang	1
bulan_kebelakang	bulan	kebelakang	1
buruh_belakangan	buruh	belakangan	1
buruk_belakangan	buruk	belakangan	1
campuran_dilatarbelakangi	campuran	dilatarbelakangi	1
celana_belakang	celana	belakang	1
cuek_belakangan	cuek	belakangan	1
curiga_belakangan	curiga	belakangan	1
da-tang_belakangan	da-tang	belakangan	1
daerah_belakang	daerah	belakang	1
daerah_belakangan	daerah	belakangan	1
daerah_belakangnya	daerah	belakangnya	1
daerah_ter-kebelakang	daerah	ter-kebelakang	1
daging_belakangan	daging	belakangan	1
dan_berlatarbelakang	dan	berlatarbelakang	1
dan_dilatarbelakangi	dan	dilatarbelakangi	1
dan_melatarbelakangi	dan	melatarbelakangi	1
dan_ter-belakang	dan	ter-belakang	1
dangkal_belakangan	dangkal	belakangan	1
dapur_membelakangi	dapur	membelakangi	1
darahnya_belakangan	darahnya	belakangan	1
darat_belakangan	darat	belakangan	1
dari_ke-terbelakangan	dari	ke-terbelakangan	1
daun_belakangan	daun	belakangan	1
de-pan-belakang_sesuai	de-pan-belakang	sesuai	1
dengan_belakang	dengan	belakang	1
dengan_dilatarbelakangi	dengan	dilatarbelakangi	1
dengan_latar-belakang	dengan	latar-belakang	1
dengan_latarbelakang	dengan	latarbelakang	1
depan-belakang_dan	depan-belakang	dan	1
deretan_belakang	deretan	belakang	1
di_belakangannya	di	belakangannya	1
di_belakangku	di	belakangku	1
di_belakangnja	di	belakangnja	1
di_depan-belakang	di	depan-belakang	1
di-latarbelakangi_oleh	di-latarbelakangi	oleh	1
di-latarbelakangi_penolakan	di-latarbelakangi	penolakan	1
di-latarbelakangi_persiapan	di-latarbelakangi	persiapan	1
dia_belakangan	dia	belakangan	1
dia_dibelakang	dia	dibelakang	1
diambil_belakangan	diambil	belakangan	1
diantaranya_belakang	diantaranya	belakang	1
diantisipasi_belakangan	diantisipasi	belakangan	1
dibayar_belakangan	dibayar	belakangan	1
dibelakang_bahkan	dibelakang	bahkan	1
dibelakang_batas	dibelakang	batas	1
dibelakang_dashboard	dibelakang	dashboard	1
dibelakang_dengan	dibelakang	dengan	1
dibelakang_gawang	dibelakang	gawang	1
dibelakang_hari	dibelakang	hari	1
dibelakang_kepala	dibelakang	kepala	1
dibelakang_kita	dibelakang	kita	1
dibelakang_lang-sung	dibelakang	lang-sung	1
dibelakang_masalah	dibelakang	masalah	1
dibelakang_masing-masing	dibelakang	masing-masing	1
dibelakang_panggung	dibelakang	panggung	1
dibelakang_penjual	dibelakang	penjual	1
dibelakang_perkembangan	dibelakang	perkembangan	1
dibelakang_rekan	dibelakang	rekan	1
dibelakang_semua	dibelakang	semua	1
dibelakang_tersangka	dibelakang	tersangka	1
dibelakang_usaha-usaha	dibelakang	usaha-usaha	1
dibelakangnya_dan	dibelakangnya	dan	1
dibelakangnya_ketus	dibelakangnya	ketus	1
diberitakan_belakangan	diberitakan	belakangan	1
dibi-carakan_belakangan	dibi-carakan	belakangan	1
dibubarkan_belakangan	dibubarkan	belakangan	1
diduga_di-latarbelakangi	diduga	di-latarbelakangi	1
diduga_melatarbelakanginya	diduga	melatarbelakanginya	1
digelar_belakang	digelar	belakang	1
digelar_belakangan	digelar	belakangan	1
digital_belakangan	digital	belakangan	1
dikabarkan_belakangan	dikabarkan	belakangan	1
dikarenakan_belakangan	dikarenakan	belakangan	1
dikatakan_belakangan	dikatakan	belakangan	1
dikembang-kan_belakangan	dikembang-kan	belakangan	1
diketa-hui_belakangan	diketa-hui	belakangan	1
dila-tarbelakangi_pemikiran	dila-tarbelakangi	pemikiran	1
dila-tarbelakangi_perbaruan	dila-tarbelakangi	perbaruan	1
dilaksanakan_belakangan	dilaksanakan	belakangan	1
dilatabelakangi_dari	dilatabelakangi	dari	1
dilatar-belakangi_karena	dilatar-belakangi	karena	1
dilatar-belakangi_oleh	dilatar-belakangi	oleh	1
dilatar-belakangi_rasa	dilatar-belakangi	rasa	1
dilatar-belakangi_sejumlah	dilatar-belakangi	sejumlah	1
dilatarbelakangi_ada	dilatarbelakangi	ada	1
dilatarbelakangi_arahan	dilatarbelakangi	arahan	1
dilatarbelakangi_balas	dilatarbelakangi	balas	1
dilatarbelakangi_bangunan	dilatarbelakangi	bangunan	1
dilatarbelakangi_daerah	dilatarbelakangi	daerah	1
dilatarbelakangi_dari	dilatarbelakangi	dari	1
dilatarbelakangi_dengan	dilatarbelakangi	dengan	1
dilatarbelakangi_dua	dilatarbelakangi	dua	1
dilatarbelakangi_dugaan	dilatarbelakangi	dugaan	1
dilatarbelakangi_faktor	dilatarbelakangi	faktor	1
dilatarbelakangi_harga	dilatarbelakangi	harga	1
dilatarbelakangi_keberadaan	dilatarbelakangi	keberadaan	1
dilatarbelakangi_kejadian	dilatarbelakangi	kejadian	1
dilatarbelakangi_kekalahan	dilatarbelakangi	kekalahan	1
dilatarbelakangi_kekecewaannya	dilatarbelakangi	kekecewaannya	1
dilatarbelakangi_kekuasaan	dilatarbelakangi	kekuasaan	1
dilatarbelakangi_keleluasaan	dilatarbelakangi	keleluasaan	1
dilatarbelakangi_keputusan	dilatarbelakangi	keputusan	1
dilatarbelakangi_kesamaan	dilatarbelakangi	kesamaan	1
dilatarbelakangi_keterpang-gilan	dilatarbelakangi	keterpang-gilan	1
dilatarbelakangi_ketidakpuasan	dilatarbelakangi	ketidakpuasan	1
dilatarbelakangi_kisah	dilatarbelakangi	kisah	1
dilatarbelakangi_kondisi	dilatarbelakangi	kondisi	1
dilatarbelakangi_letak	dilatarbelakangi	letak	1
dilatarbelakangi_mafia-mafia	dilatarbelakangi	mafia-mafia	1
dilatarbelakangi_marginalisasi	dilatarbelakangi	marginalisasi	1
dilatarbelakangi_masalah	dilatarbelakangi	masalah	1
dilatarbelakangi_negara-negara	dilatarbelakangi	negara-negara	1
dilatarbelakangi_niat	dilatarbelakangi	niat	1
dilatarbelakangi_pemikiran	dilatarbelakangi	pemikiran	1
dilatarbelakangi_penonton	dilatarbelakangi	penonton	1
dilatarbelakangi_permainan	dilatarbelakangi	permainan	1
dilatarbelakangi_permasalahan	dilatarbelakangi	permasalahan	1
dilatarbelakangi_persai-ngan	dilatarbelakangi	persai-ngan	1
dilatarbelakangi_pertanggungjawaban	dilatarbelakangi	pertanggungjawaban	1
dilatarbelakangi_pertumbuhan	dilatarbelakangi	pertumbuhan	1
dilatarbelakangi_perubahan	dilatarbelakangi	perubahan	1
dilatarbelakangi_prestasi	dilatarbelakangi	prestasi	1
dilatarbelakangi_sikap	dilatarbelakangi	sikap	1
dilatarbelakangi_sistem	dilatarbelakangi	sistem	1
dilatarbelakangi_temuan	dilatarbelakangi	temuan	1
dilatarbelakangi_teror	dilatarbelakangi	teror	1
dilatarbelakangi_terus	dilatarbelakangi	terus	1
dilatarbelakangi_tingginya	dilatarbelakangi	tingginya	1
dilatarbelakangi_unsur	dilatarbelakangi	unsur	1
dilatarbelakangi_untuk	dilatarbelakangi	untuk	1
dilatarbelakangi_upaya	dilatarbelakangi	upaya	1
dingin_dilatarbelakangi	dingin	dilatarbelakangi	1
dipastikan_latarbelakang	dipastikan	latarbelakang	1
diperdebatkan_belakangan	diperdebatkan	belakangan	1
disangka_belakangan	disangka	belakangan	1
disayangkan_belakangan	disayangkan	belakangan	1
disebut-sebut_belakangan	disebut-sebut	belakangan	1
disembunyikan_dibelakang	disembunyikan	dibelakang	1
diskriminasi_berlatarbelakang	diskriminasi	berlatarbelakang	1
ditempuh_belakangan	ditempuh	belakangan	1
ditentukan_belakangan	ditentukan	belakangan	1
diungkap_belakangan	diungkap	belakangan	1
diwacanakan_belakangan	diwacanakan	belakangan	1
dkk_belakangan	dkk	belakangan	1
drastis_belakangan	drastis	belakangan	1
dunia_belakangan	dunia	belakangan	1
ebola_belakangan	ebola	belakangan	1
ekonomi_belakangan	ekonomi	belakangan	1
eksternal_melatarbelakangi	eksternal	melatarbelakangi	1
ekstrem_belakangan	ekstrem	belakangan	1
film_berlatarbelakang	film	berlatarbelakang	1
finis_dibelakang	finis	dibelakang	1
fosil_belakangan	fosil	belakangan	1
gas_belakangan	gas	belakangan	1
geraham_belakang	geraham	belakang	1
gerbang_belakang	gerbang	belakang	1
gerbong_belakang	gerbong	belakang	1
grip_belakang	grip	belakang	1
hadiri_belakangan	hadiri	belakangan	1
haji_belakangan	haji	belakangan	1
hambatan_belakangan	hambatan	belakangan	1
hamil_belakangan	hamil	belakangan	1
hanya_belakang	hanya	belakang	1
hanya_dilatarbelakangi	hanya	dilatarbelakangi	1
hanya_terbelakang	hanya	terbelakang	1
hari-hari_belakangan	hari-hari	belakangan	1
harus_membelakangi	harus	membelakangi	1
heboh_belakangan	heboh	belakangan	1
heran_belakangan	heran	belakangan	1
hingga_belakangan	hingga	belakangan	1
hotel_belakang	hotel	belakang	1
hukum_belakangan	hukum	belakangan	1
iga_belakang	iga	belakang	1
ikut_belakang	ikut	belakang	1
ikuti_belakangan	ikuti	belakangan	1
indikasi_latarbelakang	indikasi	latarbelakang	1
informasih_belakangan	informasih	belakangan	1
infrastruktur_belakangan	infrastruktur	belakangan	1
ini_belakang-an	ini	belakang-an	1
ini_dila-tarbelakangi	ini	dila-tarbelakangi	1
ini_dilatar-belakangi	ini	dilatar-belakangi	1
istana_membelakangi	istana	membelakangi	1
itu_dilatar-belakangi	itu	dilatar-belakangi	1
itu_melatarbelakangi	itu	melatarbelakangi	1
itu_membelakangi	itu	membelakangi	1
jadi_belakangan	jadi	belakangan	1
jalanan_belakangan	jalanan	belakangan	1
jalur_belakang	jalur	belakang	1
jauh_dibelakang	jauh	dibelakang	1
jauh_kebelakang	jauh	kebelakang	1
jauh_terkebelakang	jauh	terkebelakang	1
jenggot_belakangan	jenggot	belakangan	1
jepitan_belakang	jepitan	belakang	1
jiwa_belakangan	jiwa	belakangan	1
jok_belakang	jok	belakang	1
juga_belakang	juga	belakang	1
juga_dilatabelakangi	juga	dilatabelakangi	1
kain_belakangan	kain	belakangan	1
kaku_belakangan	kaku	belakangan	1
kalangan_belakangan	kalangan	belakangan	1
kami_belakang	kami	belakang	1
kampung_belakang	kampung	belakang	1
kamtibmas_belakang	kamtibmas	belakang	1
kan_belakang	kan	belakang	1
kanan-belakang_juga	kanan-belakang	juga	1
kanan-kiri_de-pan-belakang	kanan-kiri	de-pan-belakang	1
kandang_belakangan	kandang	belakangan	1
kantin_belakang	kantin	belakang	1
kasus_belakangan	kasus	belakangan	1
katanya_dilatarbelakangi	katanya	dilatarbelakangi	1
kaum_terbelakang	kaum	terbelakang	1
ke_belakangnya	ke	belakangnya	1
ke-miskinan_keterbelakangan	ke-miskinan	keterbelakangan	1
ke-terbelakangan_pungkasnya	ke-terbelakangan	pungkasnya	1
kebelakang_dan	kebelakang	dan	1
kebelakang_dengan	kebelakang	dengan	1
kebelakang_di	kebelakang	di	1
kebelakang_kata	kebelakang	kata	1
kebelakang_memang	kebelakang	memang	1
kebelakang_membangun	kebelakang	membangun	1
kebo_dilatarbelakangi	kebo	dilatarbelakangi	1
kebo-dohan_keterbelakangan	kebo-dohan	keterbelakangan	1
kecamatan_belakang	kecamatan	belakang	1
kedua_dilatarbelakangi	kedua	dilatarbelakangi	1
keduanya_belakangan	keduanya	belakangan	1
kehalalan_belakangan	kehalalan	belakangan	1
kejadian_belakangan	kejadian	belakangan	1
kelapa_belakangan	kelapa	belakangan	1
keliling_belakangan	keliling	belakangan	1
kemarin_dilatarbelakangi	kemarin	dilatarbelakangi	1
kemenangannya_dilatarbelakangi	kemenangannya	dilatarbelakangi	1
kemiskin-an_keterbelakangan	kemiskin-an	keterbelakangan	1
kemudian_melatarbelakangi	kemudian	melatarbelakangi	1
kencang_belakangan	kencang	belakangan	1
kepala_belakangmu	kepala	belakangmu	1
kering_belakangan	kering	belakangan	1
kerja_belakangan	kerja	belakangan	1
keterbelakangan_atau	keterbelakangan	atau	1
keterbelakangan_daerah	keterbelakangan	daerah	1
keterbelakangan_eko-nomi	keterbelakangan	eko-nomi	1
keterbelakangan_intelektual	keterbelakangan	intelektual	1
keterbelakangan_kemiskinan	keterbelakangan	kemiskinan	1
keterbelakangan_ketidak-berdayaan	keterbelakangan	ketidak-berdayaan	1
keterbelakangan_masyarakat	keterbelakangan	masyarakat	1
keterbelakangan_selama	keterbelakangan	selama	1
keterbelakangan_tetap	keterbelakangan	tetap	1
keterbelakangan_tetapi	keterbelakangan	tetapi	1
keterbelakangan_yang	keterbelakangan	yang	1
ketiga_dibelakang	ketiga	dibelakang	1
kilogram_belakangan	kilogram	belakangan	1
komisi_belakangan	komisi	belakangan	1
komplain_belakangan	komplain	belakangan	1
kondisi_belakang	kondisi	belakang	1
kondisi_belakangan	kondisi	belakangan	1
kondisi_keterbelakangan	kondisi	keterbelakangan	1
konflik_dilatarbelakangi	konflik	dilatarbelakangi	1
kontak_belakangan	kontak	belakangan	1
korban_belakangan	korban	belakangan	1
koridor_belakang	koridor	belakang	1
korupsi_belakangan	korupsi	belakangan	1
kritik_belakangan	kritik	belakangan	1
kritis_belakangan	kritis	belakangan	1
kulit_belakangan	kulit	belakangan	1
laga_belakangan	laga	belakangan	1
lagi_belakangan	lagi	belakangan	1
lagi_kebelakang	lagi	kebelakang	1
lain_terkebelakang	lain	terkebelakang	1
lakukan_belakangan	lakukan	belakangan	1
lalu_membelakangi	lalu	membelakangi	1
lampu_belakangnya	lampu	belakangnya	1
lan-tas_belakangan	lan-tas	belakangan	1
lapangan_belakangan	lapangan	belakangan	1
lata_belakang	lata	belakang	1
latar_belakang-nya	latar	belakang-nya	1
latar_belakangan	latar	belakangan	1
latar_belakangnja	latar	belakangnja	1
latar-belakang_untuk	latar-belakang	untuk	1
latar-belakang_yang	latar-belakang	yang	1
latarbelakang_ekonomi	latarbelakang	ekonomi	1
latarbelakang_faktornya	latarbelakang	faktornya	1
latarbelakang_kita	latarbelakang	kita	1
latarbelakang_pekerjaan	latarbelakang	pekerjaan	1
latarbelakang_pemindahan	latarbelakang	pemindahan	1
latarbelakang_pendidikan	latarbelakang	pendidikan	1
latarbelakang_profesi	latarbelakang	profesi	1
latarbelakang_terjadinya	latarbelakang	terjadinya	1
latarbelakang_trio	latarbelakang	trio	1
latarbelakang_ujarnya	latarbelakang	ujarnya	1
latarbelakang_yang	latarbelakang	yang	1
latarbelakangi_saya	latarbelakangi	saya	1
latarbelakangnya_ada-lah	latarbelakangnya	ada-lah	1
laut_belakang	laut	belakang	1
lebar_belakang	lebar	belakang	1
leher_belakangnya	leher	belakangnya	1
lembaga_belakangan	lembaga	belakangan	1
libur_belakangan	libur	belakangan	1
listrik_belakang	listrik	belakang	1
lorong_belakang	lorong	belakang	1
luas_belakangan	luas	belakangan	1
macam_latarbelakang	macam	latarbelakang	1
main_dibelakang	main	dibelakang	1
maju-terbelakang_peradabannya	maju-terbelakang	peradabannya	1
malah_terbelakang	malah	terbelakang	1
malam_belakangan	malam	belakangan	1
manuver_dibelakang	manuver	dibelakang	1
massa_belakangan	massa	belakangan	1
masuk_belakang	masuk	belakang	1
masuk_belakangan	masuk	belakangan	1
matrilineal_dilatarbelakangi	matrilineal	dilatarbelakangi	1
maya_belakangan	maya	belakangan	1
me-reka_belakangan	me-reka	belakangan	1
melatar_belakanginya	melatar	belakanginya	1
melatarbelakangi_apa	melatarbelakangi	apa	1
melatarbelakangi_diluncurkannya	melatarbelakangi	diluncurkannya	1
melatarbelakangi_dirinya	melatarbelakangi	dirinya	1
melatarbelakangi_gerai	melatarbelakangi	gerai	1
melatarbelakangi_ini	melatarbelakangi	ini	1
melatarbelakangi_itu	melatarbelakangi	itu	1
melatarbelakangi_kehidupan	melatarbelakangi	kehidupan	1
melatarbelakangi_kejadian	melatarbelakangi	kejadian	1
melatarbelakangi_keluarnya	melatarbelakangi	keluarnya	1
melatarbelakangi_kepentingan-nya	melatarbelakangi	kepentingan-nya	1
melatarbelakangi_kongkritnya	melatarbelakangi	kongkritnya	1
melatarbelakangi_mengapa	melatarbelakangi	mengapa	1
melatarbelakangi_naiknya	melatarbelakangi	naiknya	1
melatarbelakangi_para	melatarbelakangi	para	1
melatarbelakangi_pembuatan	melatarbelakangi	pembuatan	1
melatarbelakangi_pengembangan	melatarbelakangi	pengembangan	1
melatarbelakangi_pertemuan	melatarbelakangi	pertemuan	1
melatarbelakangi_seorang	melatarbelakangi	seorang	1
melatarbelakangi_sikapnya	melatarbelakangi	sikapnya	1
melatarbelakanginya_mengingat	melatarbelakanginya	mengingat	1
melatarbelakanginya_tukas	melatarbelakanginya	tukas	1
mele-wati_belakang	mele-wati	belakang	1
melesat_belakangan	melesat	belakangan	1
melewati_belakang	melewati	belakang	1
melihat_belakangan	melihat	belakangan	1
memanas_belakangan	memanas	belakangan	1
memasukan_belakangan	memasukan	belakangan	1
membelakangi_dia	membelakangi	dia	1
membelakangi_dinding	membelakangi	dinding	1
membelakangi_gawang	membelakangi	gawang	1
membelakangi_janganlah	membelakangi	janganlah	1
membelakangi_kehidupan	membelakangi	kehidupan	1
membelakangi_matahari	membelakangi	matahari	1
membelakangi_monumen	membelakangi	monumen	1
membelakangi_panggung	membelakangi	panggung	1
membelakangi_rel	membelakangi	rel	1
membelakangi_tebing	membelakangi	tebing	1
memijat_belakangnya	memijat	belakangnya	1
memiliki_latarbelakang	memiliki	latarbelakang	1
memilukan_belakangan	memilukan	belakangan	1
memperhatikan_belakang	memperhatikan	belakang	1
menanjak_belakangan	menanjak	belakangan	1
menarik_belakangan	menarik	belakangan	1
menariknya_belakangan	menariknya	belakangan	1
mene-puk_belakangnya	mene-puk	belakangnya	1
menembus_belakang	menembus	belakang	1
meng-ungkapkan_belakangan	meng-ungkapkan	belakangan	1
mengakui_belakangan	mengakui	belakangan	1
mengapa_belakangan	mengapa	belakangan	1
mengemuka_belakangan	mengemuka	belakangan	1
mengenai_latarbelakang	mengenai	latarbelakang	1
menghantam_belakang	menghantam	belakang	1
menghindari_keterbelakangan	menghindari	keterbelakangan	1
menguntit_dibelakangnya	menguntit	dibelakangnya	1
menjadi_terkebelakang	menjadi	terkebelakang	1
menoleh_kebelakang	menoleh	kebelakang	1
menuju_belakang	menuju	belakang	1
menurutnya_belakangan	menurutnya	belakangan	1
menyangkut_latarbelakang	menyangkut	latarbelakang	1
menyatakan_belakangan	menyatakan	belakangan	1
menyayangkan_belakangan	menyayangkan	belakangan	1
menyesal_belakangan	menyesal	belakangan	1
merasa_belakangan	merasa	belakangan	1
merasakan_keterbelakangan	merasakan	keterbelakangan	1
mereka_belakangan	mereka	belakangan	1
mes-ki_belakangan	mes-ki	belakangan	1
meskipun_belakangan	meskipun	belakangan	1
misalnya_belakangan	misalnya	belakangan	1
miskin_terbelakang	miskin	terbelakang	1
muda_belakang	muda	belakang	1
mun-cul_belakangan	mun-cul	belakangan	1
muncul_dilatarbelakangi	muncul	dilatarbelakangi	1
mundur_kebelakang	mundur	kebelakang	1
mungkin_belakang	mungkin	belakang	1
mungkin_belakangan	mungkin	belakangan	1
mungkin_melatarbelakangi	mungkin	melatarbelakangi	1
murni_dilatarbelakangi	murni	dilatarbelakangi	1
na-mun_belakangan	na-mun	belakangan	1
naik_belakangan	naik	belakangan	1
nama_belakangnya	nama	belakangnya	1
napas_belakangan	napas	belakangan	1
negara_belakangan	negara	belakangan	1
negara_terbelakang	negara	terbelakang	1
nilai-nilai_dibelakangnya	nilai-nilai	dibelakangnya	1
nomor_belakang	nomor	belakang	1
offroad_dilatarbelakangi	offroad	dilatarbelakangi	1
orang-orang_dibelakangnya	orang-orang	dibelakangnya	1
organik_dilatarbelakangi	organik	dilatarbelakangi	1
otak_dibelakang	otak	dibelakang	1
pada_belakangan	pada	belakangan	1
panel_belakang	panel	belakang	1
panen_dilatarbelakangi	panen	dilatarbelakangi	1
panggung_belakang	panggung	belakang	1
pantat_belakang	pantat	belakang	1
parah_belakangan	parah	belakangan	1
parah_dibelakang	parah	dibelakang	1
parkir_belakang	parkir	belakang	1
parkiran_belakang	parkiran	belakang	1
partisi_belakang	partisi	belakang	1
pasti_belakangan	pasti	belakangan	1
pe-main_belakangnya	pe-main	belakangnya	1
pedesaan_belakangan	pedesaan	belakangan	1
pegu-nungan_belakang	pegu-nungan	belakang	1
pejabat_belakangan	pejabat	belakangan	1
pelajar_belakangan	pelajar	belakangan	1
pelaku_belakangan	pelaku	belakangan	1
pelataran_belakang	pelataran	belakang	1
pembacokan_dilatarbelakangi	pembacokan	dilatarbelakangi	1
pembalap_dibelakangnya	pembalap	dibelakangnya	1
pembangunan_belakangan	pembangunan	belakangan	1
pembayaran_belakangan	pembayaran	belakangan	1
pembuktian_belakangan	pembuktian	belakangan	1
pembunuhannya_dilatarbelakangi	pembunuhannya	dilatarbelakangi	1
pemeriksaan_belakangan	pemeriksaan	belakangan	1
pemeriksaan_latar-belakang	pemeriksaan	latar-belakang	1
penampakan_belakang	penampakan	belakang	1
penduduk_belakangan	penduduk	belakangan	1
pengecer_belakangan	pengecer	belakangan	1
pengereman_belakang	pengereman	belakang	1
penggerak_belakang	penggerak	belakang	1
penggunaan_depan-belakang	penggunaan	depan-belakang	1
penghujan_belakangan	penghujan	belakangan	1
penutup_belakang	penutup	belakang	1
penyebabnya_belakangan	penyebabnya	belakangan	1
per_belakangnya	per	belakangnya	1
perempuan_belakangan	perempuan	belakangan	1
perkembangan_belakangan	perkembangan	belakangan	1
perlengkapan_belakang	perlengkapan	belakang	1
permasalahan_belakangan	permasalahan	belakangan	1
pers_belakangan	pers	belakangan	1
persis_membelakangi	persis	membelakangi	1
persoalan_dibelakang	persoalan	dibelakang	1
petani_belakangan	petani	belakangan	1
pin-tu_belakang	pin-tu	belakang	1
ping-gang_belakang	ping-gang	belakang	1
pinggang_belakang	pinggang	belakang	1
pinggul_belakang	pinggul	belakang	1
po-hon_belakangan	po-hon	belakangan	1
po-lisi_belakangan	po-lisi	belakangan	1
pojok_belakang	pojok	belakang	1
politik_dibelakang	politik	dibelakang	1
popular_belakangan	popular	belakangan	1
poros_belakang	poros	belakang	1
posisi_membelakangi	posisi	membelakangi	1
presiden_belakangan	presiden	belakangan	1
pria_berlatarbelakang	pria	berlatarbelakang	1
property_belakangan	property	belakangan	1
propinsi_dilatarbelakangi	propinsi	dilatarbelakangi	1
protes_dilatarbelakangi	protes	dilatarbelakangi	1
pun_latarbelakangnya	pun	latarbelakangnya	1
pung-gung_belakang	pung-gung	belakang	1
radikalisme_belakangan	radikalisme	belakangan	1
rakyat_dibelakang	rakyat	dibelakang	1
razia_belakang	razia	belakang	1
rekam_belakangan	rekam	belakangan	1
remaja_belakangan	remaja	belakangan	1
rendah_terkebelakang	rendah	terkebelakang	1
rica_belakangan	rica	belakangan	1
roda_belakangnya	roda	belakangnya	1
rumah_belakang	rumah	belakang	1
rusuk_belakang	rusuk	belakang	1
sadar_belakangan	sadar	belakangan	1
saja_belakangan	saja	belakangan	1
sakit_belakang	sakit	belakang	1
saling_belakang-membelakangi	saling	belakang-membelakangi	1
sama_dilatarbelakangi	sama	dilatarbelakangi	1
sampai_belakang	sampai	belakang	1
sampe_belakang	sampe	belakang	1
sampul_belakangnya	sampul	belakangnya	1
sangat_terbelakang	sangat	terbelakang	1
sangat_terkebelakang	sangat	terkebelakang	1
santer_belakangan	santer	belakangan	1
satunya_dilatarbelakangi	satunya	dilatarbelakangi	1
sebab_keterbelakangan	sebab	keterbelakangan	1
sejak_belakangan	sejak	belakangan	1
sek-tor_belakang	sek-tor	belakang	1
sekitar_belakang	sekitar	belakang	1
sekolah_terkebelakang	sekolah	terkebelakang	1
sektor_belakangnya	sektor	belakangnya	1
selain_berlatarbelakang	selain	berlatarbelakang	1
selain_dilatarbelakangi	selain	dilatarbelakangi	1
selatan_dibelakang	selatan	dibelakang	1
semak-semak_belakang	semak-semak	belakang	1
sementara_belakang	sementara	belakang	1
semi-final_belakangan	semi-final	belakangan	1
seminggu_belakangan	seminggu	belakangan	1
sepekan_belakang	sepekan	belakang	1
seraya_membelakangi	seraya	membelakangi	1
serta_belakang	serta	belakang	1
setelah_belakangan	setelah	belakangan	1
siapa_belakangan	siapa	belakangan	1
siapa-siapa_dibelakang	siapa-siapa	dibelakang	1
signifikan_belakangan	signifikan	belakangan	1
sirip_belakang	sirip	belakang	1
situasi_belakangan	situasi	belakangan	1
sorot_belakangan	sorot	belakangan	1
sorotan_belakangan	sorotan	belakangan	1
sosial-politik_belakangan	sosial-politik	belakangan	1
spatbor_belakang	spatbor	belakang	1
sudah_membelakangi	sudah	membelakangi	1
sudut_belakang	sudut	belakang	1
sumur_belakang	sumur	belakang	1
surat_belakangan	surat	belakangan	1
survei_belakangan	survei	belakangan	1
tadi_belakangan	tadi	belakangan	1
tahu_latarbelakang	tahu	latarbelakang	1
tali_belakangnya	tali	belakangnya	1
taman_belakang	taman	belakang	1
tambahnya_dilatarbelakangi	tambahnya	dilatarbelakangi	1
tampak_belakang	tampak	belakang	1
tanah_belakang	tanah	belakang	1
tangan_belakangan	tangan	belakangan	1
tapi_berlatarbelakang	tapi	berlatarbelakang	1
tepatnya_belakang	tepatnya	belakang	1
ter-belakang_serta	ter-belakang	serta	1
ter-kebelakang_dari	ter-kebelakang	dari	1
ter-kebelakang_di	ter-kebelakang	di	1
ter-kebelakang_khususnya	ter-kebelakang	khususnya	1
ter-lihat_belakangan	ter-lihat	belakangan	1
ter-sebut_belakangan	ter-sebut	belakangan	1
terbelakang_dalam	terbelakang	dalam	1
terbelakang_dari	terbelakang	dari	1
terbelakang_diperkirakan	terbelakang	diperkirakan	1
terbelakang_karena	terbelakang	karena	1
terbelakang_katanya	terbelakang	katanya	1
terbelakang_menuju	terbelakang	menuju	1
terbelakang_serta	terbelakang	serta	1
terbelakang_untuk	terbelakang	untuk	1
terbentuk_belakangan	terbentuk	belakangan	1
terdengar_belakangan	terdengar	belakangan	1
terguncang_belakangan	terguncang	belakangan	1
terigu_belakangan	terigu	belakangan	1
terjadi_belakang-an	terjadi	belakang-an	1
terjadi_keterbelakangan	terjadi	keterbelakangan	1
terjaga_belakangan	terjaga	belakangan	1
terkebelakang_adalah	terkebelakang	adalah	1
terkebelakang_dengan	terkebelakang	dengan	1
terkebelakang_di	terkebelakang	di	1
terkebelakang_tidak	terkebelakang	tidak	1
terluar_terbelakang	terluar	terbelakang	1
ternyata_belakangan	ternyata	belakangan	1
terorisme_belakangan	terorisme	belakangan	1
terpakai_belakangnya	terpakai	belakangnya	1
tersebut_dilatar-belakangi	tersebut	dilatar-belakangi	1
tertentu_belakangan	tertentu	belakangan	1
tertinggal_dibelakang	tertinggal	dibelakang	1
thayib_belakangan	thayib	belakangan	1
tidak_berlatarbelakang	tidak	berlatarbelakang	1
tidak_di-latarbelakangi	tidak	di-latarbelakangi	1
tidak_mem-belakangi	tidak	mem-belakangi	1
tiket_belakang	tiket	belakang	1
tim_belakang	tim	belakang	1
tim-bul_belakangan	tim-bul	belakangan	1
timnya_belakangan	timnya	belakangan	1
track_belakang	track	belakang	1
tromol_belakang	tromol	belakang	1
tubuh_belakang	tubuh	belakang	1
tumpul_dilatarbelakangi	tumpul	dilatarbelakangi	1
turun_belakangan	turun	belakangan	1
umumnya_terbelakang	umumnya	terbelakang	1
umumnya_terkebelakang	umumnya	terkebelakang	1
up_belakangan	up	belakangan	1
urusi_belakangan	urusi	belakangan	1
wajahnya_belakangan	wajahnya	belakangan	1
wakilnya_belakangan	wakilnya	belakangan	1
waktu-waktu_belakangan	waktu-waktu	belakangan	1
warga_membelakangi	warga	membelakangi	1
wila-yah_belakang	wila-yah	belakang	1
wila-yahnya_belakangan	wila-yahnya	belakangan	1
wilayah_belakang	wilayah	belakang	1
wilayah_membelakangi	wilayah	membelakangi	1
wilayah_terbelakang	wilayah	terbelakang	1
wiper_belakang	wiper	belakang	1
yakni_belakang	yakni	belakang	1
yang_belakang	yang	belakang	1
yang_bertolak-belakang	yang	bertolak-belakang	1
yang_latarbelakangi	yang	latarbelakangi	1
