ngram	w1	w2	n
ke_depan	ke	depan	3138
di_depan	di	depan	2285
masa_depan	masa	depan	1392
tahun_depan	tahun	depan	1317
pekan_depan	pekan	depan	793
ke_depannya	ke	depannya	430
depan_akan	depan	akan	292
musim_depan	musim	depan	235
depan_yang	depan	yang	212
depan_dan	depan	dan	200
lini_depan	lini	depan	173
bagian_depan	bagian	depan	160
bulan_depan	bulan	depan	155
depan_kata	depan	kata	146
depan_mata	depan	mata	144
minggu_depan	minggu	depan	143
depan_kami	depan	kami	125
depan_untuk	depan	untuk	120
depan_rumah	depan	rumah	118
depan_kita	depan	kita	112
depan_bisa	depan	bisa	108
di_depannya	di	depannya	102
masa_depannya	masa	depannya	100
depan_tidak	depan	tidak	98
depan_dengan	depan	dengan	91
depan_bangsa	depan	bangsa	90
depan_pintu	depan	pintu	85
depan_sudah	depan	sudah	85
depan_kantor	depan	kantor	80
depan_di	depan	di	78
depan_katanya	depan	katanya	78
depan_nanti	depan	nanti	77
depan_gawang	depan	gawang	75
depan_ujar	depan	ujar	71
depan_saya	depan	saya	68
depan_mereka	depan	mereka	67
terdepan_dalam	terdepan	dalam	66
depan_para	depan	para	65
kamera_depan	kamera	depan	64
dari_depan	dari	depan	61
garda_terdepan	garda	terdepan	60
depan_ada	depan	ada	59
halaman_depan	halaman	depan	57
yang_mengedepankan	yang	mengedepankan	56
depan_publik	depan	publik	55
depan_masih	depan	masih	53
depan_gedung	depan	gedung	52
depan_karena	depan	karena	50
depan_umum	depan	umum	49
dengan_mengedepankan	dengan	mengedepankan	48
depan_harus	depan	harus	47
depan_lebih	depan	lebih	47
paling_depan	paling	depan	45
depan_adalah	depan	adalah	43
pemain_depan	pemain	depan	43
tahun_kedepan	tahun	kedepan	43
garis_depan	garis	depan	42
depan_ini	depan	ini	41
lebih_mengedepankan	lebih	mengedepankan	41
tetap_mengedepankan	tetap	mengedepankan	39
depan_itu	depan	itu	37
depan_rumahnya	depan	rumahnya	36
depan_dapat	depan	dapat	35
depan_juga	depan	juga	35
terdepan_di	terdepan	di	35
depan_atau	depan	atau	33
depannya_akan	depannya	akan	33
hari_kedepan	hari	kedepan	33
dan_depan	dan	depan	32
depan_pemerintah	depan	pemerintah	31
depan_ujarnya	depan	ujarnya	31
mengedepankan_kepentingan	mengedepankan	kepentingan	31
selalu_mengedepankan	selalu	mengedepankan	31
barisan_depan	barisan	depan	29
depan_anak	depan	anak	29
depan_menjadi	depan	menjadi	29
depan_gerbang	depan	gerbang	28
depan_mobil	depan	mobil	28
pintu_depan	pintu	depan	28
ban_depan	ban	depan	27
depan_dalam	depan	dalam	27
depan_diharapkan	depan	diharapkan	27
posisi_terdepan	posisi	terdepan	27
depan_toko	depan	toko	26
harus_dikedepankan	harus	dikedepankan	26
harus_mengedepankan	harus	mengedepankan	26
yang_terdepan	yang	terdepan	26
depan_pihaknya	depan	pihaknya	25
depannya_kata	depannya	kata	25
jalan_depan	jalan	depan	25
terdepan_untuk	terdepan	untuk	25
depan_sehingga	depan	sehingga	24
dan_mengedepankan	dan	mengedepankan	23
depan_agar	depan	agar	23
depan_dari	depan	dari	23
depan_generasi	depan	generasi	23
depan_masyarakat	depan	masyarakat	23
depan_sekolah	depan	sekolah	23
depan_panggung	depan	panggung	22
depan_pekan	depan	pekan	22
mengedepankan_asas	mengedepankan	asas	22
depan_anak-anak	depan	anak-anak	21
depan_ia	depan	ia	21
kaca_depan	kaca	depan	21
depan_kamera	depan	kamera	20
depan_pada	depan	pada	20
depan_tim	depan	tim	20
ta-hun_depan	ta-hun	depan	20
depan_setelah	depan	setelah	19
depan_ungkap	depan	ungkap	19
kedepan_akan	kedepan	akan	19
pe-kan_depan	pe-kan	depan	19
akan_mengedepankan	akan	mengedepankan	18
depan_daerah	depan	daerah	18
depan_kalau	depan	kalau	18
depan_seluruh	depan	seluruh	18
depan_tandasnya	depan	tandasnya	18
depan_yakni	depan	yakni	18
bulan_kedepan	bulan	kedepan	17
depan_maka	depan	maka	17
depan_sebuah	depan	sebuah	17
depan_tak	depan	tak	17
agar_kedepan	agar	kedepan	16
depan_dia	depan	dia	16
depan_kelas	depan	kelas	16
depan_majelis	depan	majelis	16
tidak_mengedepankan	tidak	mengedepankan	16
untuk_mengedepankan	untuk	mengedepankan	16
yang_dikedepankan	yang	dikedepankan	16
depan_bakal	depan	bakal	15
depan_dirinya	depan	dirinya	15
depan_jelasnya	depan	jelasnya	15
depan_peserta	depan	peserta	15
depan_tuturnya	depan	tuturnya	15
roda_depan	roda	depan	15
start_terdepan	start	terdepan	15
terdepan_dan	terdepan	dan	15
depan_bagi	depan	bagi	14
depan_hingga	depan	hingga	14
depan_lanjut	depan	lanjut	14
depan_masjid	depan	masjid	14
depan_pasar	depan	pasar	14
depan_pungkasnya	depan	pungkasnya	14
depan_ruang	depan	ruang	14
depan_sebagai	depan	sebagai	14
depan_semua	depan	semua	14
depan_tapi	depan	tapi	14
depan_tutur	depan	tutur	14
depan_baru	depan	baru	13
depan_dunia	depan	dunia	13
depan_jelas	depan	jelas	13
depan_ke	depan	ke	13
depan_namun	depan	namun	13
depan_perlu	depan	perlu	13
depan_ratusan	depan	ratusan	13
depan_rencananya	depan	rencananya	13
depan_seperti	depan	seperti	13
depan_tandas	depan	tandas	13
didepan_mata	didepan	mata	13
kedepan_bisa	kedepan	bisa	13
kedepannya_akan	kedepannya	akan	13
arah_depan	arah	depan	12
depan_hukum	depan	hukum	12
depan_mulai	depan	mulai	12
depan_negara	depan	negara	12
depan_semakin	depan	semakin	12
depan_tegas	depan	tegas	12
depan_tukas	depan	tukas	12
depan_ungkapnya	depan	ungkapnya	12
depannya_kami	depannya	kami	12
depannya_yang	depannya	yang	12
hingga_depan	hingga	depan	12
depan_banyak	depan	banyak	11
depan_forum	depan	forum	11
depan_gereja	depan	gereja	11
depan_jadi	depan	jadi	11
depan_jika	depan	jika	11
depan_makin	depan	makin	11
depan_mungkin	depan	mungkin	11
depan_sangat	depan	sangat	11
depan_tukasnya	depan	tukasnya	11
depannya_bisa	depannya	bisa	11
garis_terdepan	garis	terdepan	11
hari_depan	hari	depan	11
kedepan_untuk	kedepan	untuk	11
ma-sa_depan	ma-sa	depan	11
mengedepankan_aspek	mengedepankan	aspek	11
sampai_depan	sampai	depan	11
sisi_depan	sisi	depan	11
baris_terdepan	baris	terdepan	10
barisan_terdepan	barisan	terdepan	10
beranda_depan	beranda	depan	10
depan_5MP	depan	5MP	10
depan_anggota	depan	anggota	10
depan_belakang	depan	belakang	10
depan_hari	depan	hari	10
depan_kotak	depan	kotak	10
depan_lanjutnya	depan	lanjutnya	10
depan_nantinya	depan	nantinya	10
depan_papar	depan	papar	10
depan_program	depan	program	10
depan_ribuan	depan	ribuan	10
depan_ruangan	depan	ruangan	10
depan_sejumlah	depan	sejumlah	10
depan_serta	depan	serta	10
depan_tentu	depan	tentu	10
depan_warga	depan	warga	10
depan_warung	depan	warung	10
depannya_ujar	depannya	ujar	10
garda_depan	garda	depan	10
gugus_depan	gugus	depan	10
kedepan_nanti	kedepan	nanti	10
mengedepankan_prinsip	mengedepankan	prinsip	10
teras_depan	teras	depan	10
depan_bersama	depan	bersama	9
depan_cerah	depan	cerah	9
depan_demikian	depan	demikian	9
depan_hanya	depan	hanya	9
depan_hotel	depan	hotel	9
depan_kamar	depan	kamar	9
depan_kampus	depan	kampus	9
depan_ketika	depan	ketika	9
depan_media	depan	media	9
depan_memang	depan	memang	9
depan_meski	depan	meski	9
depan_mulut	depan	mulut	9
depan_pabrik	depan	pabrik	9
depan_pungkas	depan	pungkas	9
depan_sebab	depan	sebab	9
depan_tambahnya	depan	tambahnya	9
depan_tepatnya	depan	tepatnya	9
depannya_ada	depannya	ada	9
depannya_di	depannya	di	9
depannya_lebih	depannya	lebih	9
depannya_tidak	depannya	tidak	9
finis_terdepan	finis	terdepan	9
lampu_depan	lampu	depan	9
mengedepankan_kualitas	mengedepankan	kualitas	9
sudah_didepan	sudah	didepan	9
terdepan_yang	terdepan	yang	9
bagian_depannya	bagian	depannya	8
depan_bukan	depan	bukan	8
depan_diperkirakan	depan	diperkirakan	8
depan_ekonomi	depan	ekonomi	8
depan_gapura	depan	gapura	8
depan_industri	depan	industri	8
depan_kawasan	depan	kawasan	8
depan_khalayak	depan	khalayak	8
depan_komputer	depan	komputer	8
depan_layar	depan	layar	8
depan_mahasiswa	depan	mahasiswa	8
depan_meja	depan	meja	8
depan_orang	depan	orang	8
depan_publiknya	depan	publiknya	8
depan_puluhan	depan	puluhan	8
depan_saat	depan	saat	8
depan_sebelum	depan	sebelum	8
depan_sidang	depan	sidang	8
depan_umat	depan	umat	8
depan_yaitu	depan	yaitu	8
depannya_dapat	depannya	dapat	8
depannya_juga	depannya	juga	8
ini_mengedepankan	ini	mengedepankan	8
juga_mengedepankan	juga	mengedepankan	8
kedepan_harus	kedepan	harus	8
kedepan_kata	kedepan	kata	8
mengedepankan_etika	mengedepankan	etika	8
mengedepankan_nilai	mengedepankan	nilai	8
mengedepankan_pendekatan	mengedepankan	pendekatan	8
mengedepankan_upaya	mengedepankan	upaya	8
serta_mengedepankan	serta	mengedepankan	8
berharap_kedepan	berharap	kedepan	7
depan_8MP	depan	8MP	7
depan_diprediksi	depan	diprediksi	7
depan_hal	depan	hal	7
depan_halaman	depan	halaman	7
depan_harga	depan	harga	7
depan_imbuh	depan	imbuh	7
depan_imbuhnya	depan	imbuhnya	7
depan_jumlah	depan	jumlah	7
depan_kan	depan	kan	7
depan_kedua	depan	kedua	7
depan_kegiatan	depan	kegiatan	7
depan_keluarga	depan	keluarga	7
depan_kondisi	depan	kondisi	7
depan_net	depan	net	7
depan_pendukung	depan	pendukung	7
depan_pun	depan	pun	7
depan_rakyat	depan	rakyat	7
depan_saja	depan	saja	7
depan_sebelah	depan	sebelah	7
depan_sedangkan	depan	sedangkan	7
depan_segera	depan	segera	7
depan_sekitar	depan	sekitar	7
depan_selain	depan	selain	7
depan_semoga	depan	semoga	7
depan_tambah	depan	tambah	7
depan_telah	depan	telah	7
depan_ucapnya	depan	ucapnya	7
depannya_adalah	depannya	adalah	7
depannya_kita	depannya	kita	7
di_kedepankan	di	kedepankan	7
dikedepankan_dalam	dikedepankan	dalam	7
ini_kedepan	ini	kedepan	7
kamar_depan	kamar	depan	7
kanan_depan	kanan	depan	7
kiri_depan	kiri	depan	7
lagi_mengedepankan	lagi	mengedepankan	7
mengedepankan_akal	mengedepankan	akal	7
mengedepankan_arogansi	mengedepankan	arogansi	7
mengedepankan_konsep	mengedepankan	konsep	7
mengedepankan_prinsip-prinsip	mengedepankan	prinsip-prinsip	7
mengedepankan_semangat	mengedepankan	semangat	7
posisi_depan	posisi	depan	7
pulau_terdepan	pulau	terdepan	7
adalah_mengedepankan	adalah	mengedepankan	6
agar_kedepannya	agar	kedepannya	6
baris_depan	baris	depan	6
dan_kedepan	dan	kedepan	6
depan_atlet	depan	atlet	6
depan_dermaga	depan	dermaga	6
depan_dua	depan	dua	6
depan_hakim	depan	hakim	6
depan_jalan	depan	jalan	6
depan_jangan	depan	jangan	6
depan_kompleks	depan	kompleks	6
depan_lokasi	depan	lokasi	6
depan_masalah	depan	masalah	6
depan_memiliki	depan	memiliki	6
depan_menurut	depan	menurut	6
depan_nan-ti	depan	nan-ti	6
depan_pendidikan	depan	pendidikan	6
depan_penonton	depan	penonton	6
depan_penyidik	depan	penyidik	6
depan_pertokoan	depan	pertokoan	6
depan_pihak	depan	pihak	6
depan_seiring	depan	seiring	6
depan_selesai	depan	selesai	6
depan_sementara	depan	sementara	6
depan_sistem	depan	sistem	6
depan_tantangan	depan	tantangan	6
depan_target	depan	target	6
depan_tegasnya	depan	tegasnya	6
depan_terang	depan	terang	6
depan_terdapat	depan	terdapat	6
depan_tersebut	depan	tersebut	6
depan_tetap	depan	tetap	6
depan_tetapi	depan	tetapi	6
depan_truk	depan	truk	6
depan_ucap	depan	ucap	6
depannya_bersama	depannya	bersama	6
depannya_dan	depannya	dan	6
depannya_seperti	depannya	seperti	6
depannya_tak	depannya	tak	6
kedepan_dapat	kedepan	dapat	6
kedepan_yang	kedepan	yang	6
kedepannya_bisa	kedepannya	bisa	6
kursi_depan	kursi	depan	6
masih_mengedepankan	masih	mengedepankan	6
mengedepankan_nilai-nilai	mengedepankan	nilai-nilai	6
mengedepankan_sikap	mengedepankan	sikap	6
mengedepankan_unsur	mengedepankan	unsur	6
minggu_kedepan	minggu	kedepan	6
rem_depan	rem	depan	6
teknologi_terdepan	teknologi	terdepan	6
yang_mengedepan	yang	mengedepan	6
baik_kedepannya	baik	kedepannya	5
berharap_kedepannya	berharap	kedepannya	5
bumper_depan	bumper	depan	5
dan_kedepannya	dan	kedepannya	5
depan_altar	depan	altar	5
depan_bagian	depan	bagian	5
depan_balai	depan	balai	5
depan_berada	depan	berada	5
depan_dipastikan	depan	dipastikan	5
depan_direncanakan	depan	direncanakan	5
depan_guna	depan	guna	5
depan_hidung	depan	hidung	5
depan_istana	depan	istana	5
depan_kendaraan	depan	kendaraan	5
depan_kiri	depan	kiri	5
depan_kota	depan	kota	5
depan_lawan	depan	lawan	5
depan_loket	depan	loket	5
depan_motor	depan	motor	5
depan_nama	depan	nama	5
depan_partai	depan	partai	5
depan_pasti	depan	pasti	5
depan_patung	depan	patung	5
depan_pelatih	depan	pelatih	5
depan_pemain	depan	pemain	5
depan_persidangan	depan	persidangan	5
depan_pria	depan	pria	5
depan_sambil	depan	sambil	5
depan_satu	depan	satu	5
depan_sebaiknya	depan	sebaiknya	5
depan_sebesar	depan	sebesar	5
depan_sepeda	depan	sepeda	5
depan_seseorang	depan	seseorang	5
depan_sesuai	depan	sesuai	5
depan_setiap	depan	setiap	5
depan_stasiun	depan	stasiun	5
depan_tanpa	depan	tanpa	5
depan_terangnya	depan	terangnya	5
depan_terkait	depan	terkait	5
depan_wajah	depan	wajah	5
depannya_dengan	depannya	dengan	5
depannya_dia	depannya	dia	5
depannya_diharapkan	depannya	diharapkan	5
depannya_jelas	depannya	jelas	5
depannya_masih	depannya	masih	5
depannya_mereka	depannya	mereka	5
depannya_sehingga	depannya	sehingga	5
depannya_sudah	depannya	sudah	5
depannya_ujarnya	depannya	ujarnya	5
depannya_untuk	depannya	untuk	5
digital_terdepan	digital	terdepan	5
hanya_mengedepankan	hanya	mengedepankan	5
itu_kedepannya	itu	kedepannya	5
kamera_depannya	kamera	depannya	5
ke_depan-nya	ke	depan-nya	5
kedepan_dalam	kedepan	dalam	5
kedepan_jelas	kedepan	jelas	5
kedepan_sudah	kedepan	sudah	5
kedepan_tidak	kedepan	tidak	5
kedepannya_kata	kedepannya	kata	5
kompetisi_depan	kompetisi	depan	5
lagi_kedepannya	lagi	kedepannya	5
melewati_depan	melewati	depan	5
mengedepankan_transparansi	mengedepankan	transparansi	5
pebalap_terdepan	pebalap	terdepan	5
pembalap_terdepan	pembalap	terdepan	5
pilar_terdepan	pilar	terdepan	5
sampul_depan	sampul	depan	5
terdepan_terluar	terdepan	terluar	5
terus_mengedepankan	terus	mengedepankan	5
tetap_menge-depankan	tetap	menge-depankan	5
agar_mengedepankan	agar	mengedepankan	4
area_depan	area	depan	4
atau_depan	atau	depan	4
bemper_depan	bemper	depan	4
contoh_terdepan	contoh	terdepan	4
dalam_mengedepankan	dalam	mengedepankan	4
dan_terdepan	dan	terdepan	4
depan_antara	depan	antara	4
depan_apa	depan	apa	4
depan_aparat	depan	aparat	4
depan_area	depan	area	4
depan_baik	depan	baik	4
depan_barisan	depan	barisan	4
depan_begitu	depan	begitu	4
depan_bengkel	depan	bengkel	4
depan_berjalan	depan	berjalan	4
depan_bus	depan	bus	4
depan_dekat	depan	dekat	4
depan_gemilang	depan	gemilang	4
depan_gerakan	depan	gerakan	4
depan_gubernur	depan	gubernur	4
depan_ingin	depan	ingin	4
depan_investasi	depan	investasi	4
depan_jajaran	depan	jajaran	4
depan_jalur	depan	jalur	4
depan_jauh	depan	jauh	4
depan_jenazah	depan	jenazah	4
depan_kaca	depan	kaca	4
depan_kasus	depan	kasus	4
depan_kemungkinan	depan	kemungkinan	4
depan_khususnya	depan	khususnya	4
depan_kios	depan	kios	4
depan_kompetisi	depan	kompetisi	4
depan_lahan	depan	lahan	4
depan_lalu	depan	lalu	4
depan_langkah	depan	langkah	4
depan_lantaran	depan	lantaran	4
depan_lewat	depan	lewat	4
depan_lobi	depan	lobi	4
depan_makam	depan	makam	4
depan_mampu	depan	mampu	4
depan_massa	depan	massa	4
depan_matanya	depan	matanya	4
depan_maupun	depan	maupun	4
depan_megapiksel	depan	megapiksel	4
depan_membutuhkan	depan	membutuhkan	4
depan_mencapai	depan	mencapai	4
depan_merupakan	depan	merupakan	4
depan_mudah-mudahan	depan	mudah-mudahan	4
depan_negeri	depan	negeri	4
depan_pangkalan	depan	pangkalan	4
depan_pantai	depan	pantai	4
depan_pe-kan	depan	pe-kan	4
depan_pembangunan	depan	pembangunan	4
depan_pengurus	depan	pengurus	4
depan_pertumbuhan	depan	pertumbuhan	4
depan_pesawat	depan	pesawat	4
depan_petugas	depan	petugas	4
depan_pi-haknya	depan	pi-haknya	4
depan_polisi	depan	polisi	4
depan_produksi	depan	produksi	4
depan_rapat	depan	rapat	4
depan_rumah-rumah	depan	rumah-rumah	4
depan_salah	depan	salah	4
depan_sampai	depan	sampai	4
depan_samping	depan	samping	4
depan_seharusnya	depan	seharusnya	4
depan_siswa	depan	siswa	4
depan_stadion	depan	stadion	4
depan_televisi	depan	televisi	4
depan_terhitung	depan	terhitung	4
depan_termasuk	depan	termasuk	4
depan_terminal	depan	terminal	4
depan_terus	depan	terus	4
depan_tiga	depan	tiga	4
depan_torang	depan	torang	4
depan_walau	depan	walau	4
depannya_jika	depannya	jika	4
depannya_saya	depannya	saya	4
depannya_semakin	depannya	semakin	4
diharapkan_kedepan	diharapkan	kedepan	4
dikedepankan_dan	dikedepankan	dan	4
hukum_mengedepankan	hukum	mengedepankan	4
ingin_mengedepankan	ingin	mengedepankan	4
itu_kedepan	itu	kedepan	4
jendela_depan	jendela	depan	4
kaca_depannya	kaca	depannya	4
kedepan_agar	kedepan	agar	4
kedepan_dengan	kedepan	dengan	4
kedepan_katanya	kedepan	katanya	4
kedepan_ujar	kedepan	ujar	4
kedepan_ujarnya	kedepan	ujarnya	4
kedepannya_dapat	kedepannya	dapat	4
kita_mengedepankan	kita	mengedepankan	4
lapangan_depan	lapangan	depan	4
lebih_dikedepankan	lebih	dikedepankan	4
mampu_mengedepankan	mampu	mengedepankan	4
mengedepankan_aturan	mengedepankan	aturan	4
mengedepankan_kampanye	mengedepankan	kampanye	4
mengedepankan_kewajiban	mengedepankan	kewajiban	4
mengedepankan_proses	mengedepankan	proses	4
mengedepankan_sportivitas	mengedepankan	sportivitas	4
menjadi_terdepan	menjadi	terdepan	4
mereka_mengedepankan	mereka	mengedepankan	4
minggu_depannya	minggu	depannya	4
nama_depannya	nama	depannya	4
patut_dikedepankan	patut	dikedepankan	4
pekan_kedepan	pekan	kedepan	4
perempatan_depan	perempatan	depan	4
pulau-pulau_terdepan	pulau-pulau	terdepan	4
ruang_depan	ruang	depan	4
ruangan_depan	ruangan	depan	4
selalu_terdepan	selalu	terdepan	4
senantiasa_mengedepankan	senantiasa	mengedepankan	4
suspensi_depan	suspensi	depan	4
terdepan_da-lam	terdepan	da-lam	4
terdepan_dengan	terdepan	dengan	4
terdepan_pada	terdepan	pada	4
terluar_terdepan	terluar	terdepan	4
untuk_dikedepankan	untuk	dikedepankan	4
urutan_terdepan	urutan	terdepan	4
yang_kedepannya	yang	kedepannya	4
3T_terdepan	3T	terdepan	3
akan_dikedepankan	akan	dikedepankan	3
bagian_terdepan	bagian	terdepan	3
bangsa_kedepannya	bangsa	kedepannya	3
bank_terdepan	bank	terdepan	3
bola-bola_depan	bola-bola	depan	3
daerah_kedepan	daerah	kedepan	3
daerah_terdepan	daerah	terdepan	3
dengan_me-ngedepankan	dengan	me-ngedepankan	3
dengan_mengedepan-kan	dengan	mengedepan-kan	3
depan_aktivitas	depan	aktivitas	3
depan_aku	depan	aku	3
depan_anak-anaknya	depan	anak-anaknya	3
depan_anaknya	depan	anaknya	3
depan_asal	depan	asal	3
depan_badan	depan	badan	3
depan_bagaimana	depan	bagaimana	3
depan_bangunan	depan	bangunan	3
depan_belum	depan	belum	3
depan_benar-benar	depan	benar-benar	3
depan_berencana	depan	berencana	3
depan_berkas	depan	berkas	3
depan_berlaku	depan	berlaku	3
depan_besok	depan	besok	3
depan_betul-betul	depan	betul-betul	3
depan_bila	depan	bila	3
depan_buat	depan	buat	3
depan_dana	depan	dana	3
depan_daya	depan	daya	3
depan_de-ngan	depan	de-ngan	3
depan_demi	depan	demi	3
depan_deretan	depan	deretan	3
depan_desa	depan	desa	3
depan_destinasi	depan	destinasi	3
depan_dimulai	depan	dimulai	3
depan_disusul	depan	disusul	3
depan_ditargetkan	depan	ditargetkan	3
depan_film	depan	film	3
depan_gaji	depan	gaji	3
depan_garis	depan	garis	3
depan_hancur	depan	hancur	3
depan_harapan	depan	harapan	3
depan_hujan	depan	hujan	3
depan_instansi	depan	instansi	3
depan_insya	depan	insya	3
depan_investor	depan	investor	3
depan_ka-tanya	depan	ka-tanya	3
depan_kan-tor	depan	kan-tor	3
depan_kanan	depan	kanan	3
depan_kedai	depan	kedai	3
depan_keluarganya	depan	keluarganya	3
depan_kemudian	depan	kemudian	3
depan_kepada	depan	kepada	3
depan_kinerja	depan	kinerja	3
depan_kiranya	depan	kiranya	3
depan_klub	depan	klub	3
depan_kondisinya	depan	kondisinya	3
depan_konsep	depan	konsep	3
depan_korban	depan	korban	3
depan_laporan	depan	laporan	3
depan_ma-syarakat	depan	ma-syarakat	3
depan_markas	depan	markas	3
depan_me-reka	depan	me-reka	3
depan_melakukan	depan	melakukan	3
depan_melalui	depan	melalui	3
depan_mempunyai	depan	mempunyai	3
depan_menghapus	depan	menghapus	3
depan_mengingat	depan	mengingat	3
depan_mobilnya	depan	mobilnya	3
depan_muncul	depan	muncul	3
depan_museum	depan	museum	3
depan_naik	depan	naik	3
depan_oleh	depan	oleh	3
depan_pagar	depan	pagar	3
depan_paling	depan	paling	3
depan_parlemen	depan	parlemen	3
depan_pasukan	depan	pasukan	3
depan_pebalap	depan	pebalap	3
depan_pejabat	depan	pejabat	3
depan_pelanggan	depan	pelanggan	3
depan_pemberantasan	depan	pemberantasan	3
depan_pendopo	depan	pendopo	3
depan_pendukungnya	depan	pendukungnya	3
depan_penjaga	depan	penjaga	3
depan_perusahaan	depan	perusahaan	3
depan_petani	depan	petani	3
depan_politik	depan	politik	3
depan_pos	depan	pos	3
depan_prestasi	depan	prestasi	3
depan_produk	depan	produk	3
depan_proses	depan	proses	3
depan_proyek	depan	proyek	3
depan_public	depan	public	3
depan_rektorat	depan	rektorat	3
depan_ru-mahnya	depan	ru-mahnya	3
depan_sana	depan	sana	3
depan_saran	depan	saran	3
depan_sebenarnya	depan	sebenarnya	3
depan_sebut	depan	sebut	3
depan_secara	depan	secara	3
depan_sedang	depan	sedang	3
depan_sekaligus	depan	sekaligus	3
depan_sekarang	depan	sekarang	3
depan_sekolahnya	depan	sekolahnya	3
depan_semuanya	depan	semuanya	3
depan_seorang	depan	seorang	3
depan_sepak	depan	sepak	3
depan_sepertinya	depan	sepertinya	3
depan_setidaknya	depan	setidaknya	3
depan_suatu	depan	suatu	3
depan_surat	depan	surat	3
depan_tampak	depan	tampak	3
depan_tanah	depan	tanah	3
depan_tanggal	depan	tanggal	3
depan_teknologi	depan	teknologi	3
depan_teman-temannya	depan	teman-temannya	3
depan_teras	depan	teras	3
depan_terbuka	depan	terbuka	3
depan_terlihat	depan	terlihat	3
depan_terutama	depan	terutama	3
depan_timnya	depan	timnya	3
depan_tinggal	depan	tinggal	3
depan_toilet	depan	toilet	3
depan_triliun	depan	triliun	3
depan_wartawan	depan	wartawan	3
depan_wilayah	depan	wilayah	3
depan_ya	depan	ya	3
depannya_apakah	depannya	apakah	3
depannya_dari	depannya	dari	3
depannya_katanya	depannya	katanya	3
depannya_lanjut	depannya	lanjut	3
depannya_nanti	depannya	nanti	3
depannya_pemerintah	depannya	pemerintah	3
depannya_seluruh	depannya	seluruh	3
depannya_setelah	depannya	setelah	3
depannya_terus	depannya	terus	3
depannya_tetap	depannya	tetap	3
depannya_ucapnya	depannya	ucapnya	3
depannya_ungkap	depannya	ungkap	3
dibagian_depan	dibagian	depan	3
dikedepankan_adalah	dikedepankan	adalah	3
dikedepankan_dari	dikedepankan	dari	3
dimasa_depan	dimasa	depan	3
grill_depan	grill	depan	3
harapan_kedepan	harapan	kedepan	3
harus_me-ngedepankan	harus	me-ngedepankan	3
ini_kedepannya	ini	kedepannya	3
itu_dikedepankan	itu	dikedepankan	3
kami_kedepan	kami	kedepan	3
kami_kedepankan	kami	kedepankan	3
kedepan_adalah	kedepan	adalah	3
kedepan_dan	kedepan	dan	3
kedepan_masih	kedepan	masih	3
kedepan_tutur	kedepan	tutur	3
kedepankan_adalah	kedepankan	adalah	3
kedepankan_sikap	kedepankan	sikap	3
kedepannya_jelasnya	kedepannya	jelasnya	3
kedepannya_kami	kedepannya	kami	3
kedepannya_lebih	kedepannya	lebih	3
kedepannya_tidak	kedepannya	tidak	3
kita_kedepankan	kita	kedepankan	3
lebih_depan	lebih	depan	3
lini_depannya	lini	depannya	3
lini_terdepan	lini	terdepan	3
lurus_kedepan	lurus	kedepan	3
maupun_depan	maupun	depan	3
me-ngedepankan_asas	me-ngedepankan	asas	3
menge-depankan_asas	menge-depankan	asas	3
menge-depankan_kepentingan	menge-depankan	kepentingan	3
mengedepankan_berbagai	mengedepankan	berbagai	3
mengedepankan_cara-cara	mengedepankan	cara-cara	3
mengedepankan_dan	mengedepankan	dan	3
mengedepankan_faktor	mengedepankan	faktor	3
mengedepankan_fungsi	mengedepankan	fungsi	3
mengedepankan_hal-hal	mengedepankan	hal-hal	3
mengedepankan_inovasi	mengedepankan	inovasi	3
mengedepankan_isu-isu	mengedepankan	isu-isu	3
mengedepankan_kasih	mengedepankan	kasih	3
mengedepankan_keamanan	mengedepankan	keamanan	3
mengedepankan_kejujuran	mengedepankan	kejujuran	3
mengedepankan_kemandirian	mengedepankan	kemandirian	3
mengedepankan_komunikasi	mengedepankan	komunikasi	3
mengedepankan_langkah	mengedepankan	langkah	3
mengedepankan_moral	mengedepankan	moral	3
mengedepankan_pelayanan	mengedepankan	pelayanan	3
mengedepankan_pembangunan	mengedepankan	pembangunan	3
mengedepankan_perbedaan	mengedepankan	perbedaan	3
mengedepankan_persamaan	mengedepankan	persamaan	3
mengedepankan_persatuan	mengedepankan	persatuan	3
mengedepankan_program	mengedepankan	program	3
mengedepankan_rasa	mengedepankan	rasa	3
mengedepankan_sisi	mengedepankan	sisi	3
mengedepankan_sistem	mengedepankan	sistem	3
moncong_depan	moncong	depan	3
pentingnya_mengedepankan	pentingnya	mengedepankan	3
raya_depan	raya	depan	3
rencana_kedepan	rencana	kedepan	3
sehingga_kedepan	sehingga	kedepan	3
sektor_depan	sektor	depan	3
selalu_dikedepankan	selalu	dikedepankan	3
serambi_depan	serambi	depan	3
tahun-tahun_depan	tahun-tahun	depan	3
tampak_depan	tampak	depan	3
tampil_terdepan	tampil	terdepan	3
taon_depan	taon	depan	3
tepatnya_depan	tepatnya	depan	3
terdepan_harus	terdepan	harus	3
terdepan_kata	terdepan	kata	3
terdepan_katanya	terdepan	katanya	3
terdepan_membela	terdepan	membela	3
terdepan_saat	terdepan	saat	3
terdepan_sebagai	terdepan	sebagai	3
terdepan_seperti	terdepan	seperti	3
tetap_dikedepankan	tetap	dikedepankan	3
tetap_me-ngedepankan	tetap	me-ngedepankan	3
trotoar_depan	trotoar	depan	3
untuk_kedepan	untuk	kedepan	3
waktu_kedepan	waktu	kedepan	3
warung_depan	warung	depan	3
wilayah_terdepan	wilayah	terdepan	3
yang_menge-depankan	yang	menge-depankan	3
ada_didepan	ada	didepan	2
ada_didepannya	ada	didepannya	2
akan_me-ngedepankan	akan	me-ngedepankan	2
bahwa_kedepannya	bahwa	kedepannya	2
bangku_depan	bangku	depan	2
berada_didepan	berada	didepan	2
bola_depan	bola	depan	2
bu-lan_depan	bu-lan	depan	2
bundel_depan	bundel	depan	2
dan_kedepankan	dan	kedepankan	2
dapat_mengedepankan	dapat	mengedepankan	2
dengan_menge-depankan	dengan	menge-depankan	2
depan_2MP	depan	2MP	2
depan_agenda	depan	agenda	2
depan_alumni	depan	alumni	2
depan_aman	depan	aman	2
depan_amat	depan	amat	2
depan_anggaran	depan	anggaran	2
depan_animo	depan	animo	2
depan_apabila	depan	apabila	2
depan_apalagi	depan	apalagi	2
depan_asrama	depan	asrama	2
depan_atlet-atlet	depan	atlet-atlet	2
depan_awak	depan	awak	2
depan_bahwa	depan	bahwa	2
depan_bandara	depan	bandara	2
depan_bangkai	depan	bangkai	2
depan_beber	depan	beber	2
depan_bebernya	depan	bebernya	2
depan_bentuk	depan	bentuk	2
depan_berbagai	depan	berbagai	2
depan_bersama-sama	depan	bersama-sama	2
depan_bersamaan	depan	bersamaan	2
depan_bertambah	depan	bertambah	2
depan_berusia	depan	berusia	2
depan_biasanya	depan	biasanya	2
depan_bicara	depan	bicara	2
depan_bintang	depan	bintang	2
depan_buatan	depan	buatan	2
depan_bukanlah	depan	bukanlah	2
depan_bumi	depan	bumi	2
depan_bunga	depan	bunga	2
depan_busana	depan	busana	2
depan_cermin	depan	cermin	2
depan_curah	depan	curah	2
depan_dada	depan	dada	2
depan_daerah-daerah	depan	daerah-daerah	2
depan_dampaknya	depan	dampaknya	2
depan_dewan	depan	dewan	2
depan_dibangun	depan	dibangun	2
depan_dibuat	depan	dibuat	2
depan_difokuskan	depan	difokuskan	2
depan_digelar	depan	digelar	2
depan_digital	depan	digital	2
depan_diha-rapkan	depan	diha-rapkan	2
depan_dilaksanakan	depan	dilaksanakan	2
depan_dilengkapi	depan	dilengkapi	2
depan_dinas	depan	dinas	2
depan_dinilai	depan	dinilai	2
depan_dipegang	depan	dipegang	2
depan_disebut	depan	disebut	2
depan_disergap	depan	disergap	2
depan_dos	depan	dos	2
depan_duet	depan	duet	2
depan_dukungan	depan	dukungan	2
depan_e-warung	depan	e-warung	2
depan_etalase	depan	etalase	2
depan_event	depan	event	2
depan_fans	depan	fans	2
depan_front	depan	front	2
depan_fungsi	depan	fungsi	2
depan_gang	depan	gang	2
depan_gerai	depan	gerai	2
depan_giliran	depan	giliran	2
depan_grup	depan	grup	2
depan_halte	depan	halte	2
depan_handset	depan	handset	2
depan_hasil	depan	hasil	2
depan_hubungan	depan	hubungan	2
depan_impor	depan	impor	2
depan_induk	depan	induk	2
depan_inflasi	depan	inflasi	2
depan_intensitas	depan	intensitas	2
depan_istri	depan	istri	2
depan_istrinya	depan	istrinya	2
depan_izin	depan	izin	2
depan_jagung	depan	jagung	2
depan_jembatan	depan	jembatan	2
depan_juara	depan	juara	2
depan_jumlahnya	depan	jumlahnya	2
depan_juri	depan	juri	2
depan_ka-mi	depan	ka-mi	2
depan_kabin	depan	kabin	2
depan_kabupaten	depan	kabupaten	2
depan_kaki	depan	kaki	2
depan_kap	depan	kap	2
depan_kare-na	depan	kare-na	2
depan_kediaman	depan	kediaman	2
depan_keduanya	depan	keduanya	2
depan_kedutaan	depan	kedutaan	2
depan_kembali	depan	kembali	2
depan_keputusan	depan	keputusan	2
depan_kereta	depan	kereta	2
depan_kerja	depan	kerja	2
depan_kerumunan	depan	kerumunan	2
depan_ketidakpastian	depan	ketidakpastian	2
depan_keuangan	depan	keuangan	2
depan_koalisi	depan	koalisi	2
depan_komposisi	depan	komposisi	2
depan_konflik	depan	konflik	2
depan_kongres	depan	kongres	2
depan_kualitas	depan	kualitas	2
depan_kuncinya	depan	kuncinya	2
depan_lagi	depan	lagi	2
depan_lah	depan	lah	2
depan_langsung	depan	langsung	2
depan_lembaga	depan	lembaga	2
depan_lima	depan	lima	2
depan_lingkungan	depan	lingkungan	2
depan_mal	depan	mal	2
depan_mall-mall	depan	mall-mall	2
depan_manajemen	depan	manajemen	2
depan_manusia	depan	manusia	2
depan_mari	depan	mari	2
depan_mau	depan	mau	2
depan_melibatkan	depan	melibatkan	2
depan_melihat	depan	melihat	2
depan_membangun	depan	membangun	2
depan_mencoba	depan	mencoba	2
depan_mengalami	depan	mengalami	2
depan_menggunakan	depan	menggunakan	2
depan_menghadapi	depan	menghadapi	2
depan_mengingatkan	depan	mengingatkan	2
depan_mengisi	depan	mengisi	2
depan_meningkat	depan	meningkat	2
depan_menjadikan	depan	menjadikan	2
depan_menuju	depan	menuju	2
depan_minggu	depan	minggu	2
depan_model	depan	model	2
depan_mukanya	depan	mukanya	2
depan_mulutnya	depan	mulutnya	2
depan_murid	depan	murid	2
depan_negara-negara	depan	negara-negara	2
depan_nelayan	depan	nelayan	2
depan_olahraga	depan	olahraga	2
depan_paparnya	depan	paparnya	2
depan_pariwisata	depan	pariwisata	2
depan_pasangannya	depan	pasangannya	2
depan_pasien	depan	pasien	2
depan_pecah	depan	pecah	2
depan_pembalap	depan	pembalap	2
depan_pembayaran	depan	pembayaran	2
depan_pembenahan	depan	pembenahan	2
depan_pemberian	depan	pemberian	2
depan_pemimpin	depan	pemimpin	2
depan_pemkab	depan	pemkab	2
depan_pemkot	depan	pemkot	2
depan_pendapatannya	depan	pendapatannya	2
depan_peneliti	depan	peneliti	2
depan_penerimaan	depan	penerimaan	2
depan_pengadilan	depan	pengadilan	2
depan_penggunaan	depan	penggunaan	2
depan_pengunjung	depan	pengunjung	2
depan_penjualan	depan	penjualan	2
depan_penting	depan	penting	2
depan_penyerapan	depan	penyerapan	2
depan_peran	depan	peran	2
depan_perang	depan	perang	2
depan_perekonomian	depan	perekonomian	2
depan_periode	depan	periode	2
depan_perjanjian	depan	perjanjian	2
depan_perjuangan	depan	perjuangan	2
depan_perkembangan	depan	perkembangan	2
depan_perpustakaan	depan	perpustakaan	2
depan_pertempuran	depan	pertempuran	2
depan_pertigaan	depan	pertigaan	2
depan_perwakilan	depan	perwakilan	2
depan_pesannya	depan	pesannya	2
depan_pihak-nya	depan	pihak-nya	2
depan_pimpinan	depan	pimpinan	2
depan_pindah	depan	pindah	2
depan_pinta	depan	pinta	2
depan_pohon	depan	pohon	2
depan_pola	depan	pola	2
depan_ponsel	depan	ponsel	2
depan_porsi	depan	porsi	2
depan_praktis	depan	praktis	2
depan_program-program	depan	program-program	2
depan_pusara	depan	pusara	2
depan_pusat	depan	pusat	2
depan_red	depan	red	2
depan_rincian	depan	rincian	2
depan_ringsek	depan	ringsek	2
depan_robot	depan	robot	2
depan_ru-mah	depan	ru-mah	2
depan_ruko	depan	ruko	2
depan_rumah-nya	depan	rumah-nya	2
depan_sambung	depan	sambung	2
depan_sambungnya	depan	sambungnya	2
depan_sang	depan	sang	2
depan_sangatlah	depan	sangatlah	2
depan_se	depan	se	2
depan_se-hingga	depan	se-hingga	2
depan_se-telah	depan	se-telah	2
depan_sebagian	depan	sebagian	2
depan_sebanyak	depan	sebanyak	2
depan_segalanya	depan	segalanya	2
depan_sektor	depan	sektor	2
depan_selalu	depan	selalu	2
depan_selama	depan	selama	2
depan_siapapun	depan	siapapun	2
depan_simpul	depan	simpul	2
depan_sisi	depan	sisi	2
depan_skuad	depan	skuad	2
depan_stan	depan	stan	2
depan_su-dah	depan	su-dah	2
depan_sumber	depan	sumber	2
depan_superblok	depan	superblok	2
depan_tabung	depan	tabung	2
depan_tahun	depan	tahun	2
depan_taman	depan	taman	2
depan_tamu	depan	tamu	2
depan_tanggul	depan	tanggul	2
depan_tank	depan	tank	2
depan_telepon	depan	telepon	2
depan_tenda	depan	tenda	2
depan_tentunya	depan	tentunya	2
depan_tergantung	depan	tergantung	2
depan_terjadi	depan	terjadi	2
depan_ternyata	depan	ternyata	2
depan_tertulis	depan	tertulis	2
depan_ti-dak	depan	ti-dak	2
depan_tidaklah	depan	tidaklah	2
depan_tribun	depan	tribun	2
depan_trio	depan	trio	2
depan_tugas	depan	tugas	2
depan_tugu	depan	tugu	2
depan_tukas-nya	depan	tukas-nya	2
depan_tulis	depan	tulis	2
depan_turun	depan	turun	2
depan_tutupnya	depan	tutupnya	2
depan_un-tuk	depan	un-tuk	2
depan_usai	depan	usai	2
depan_usulan	depan	usulan	2
depanlah_yang	depanlah	yang	2
depannya_agar	depannya	agar	2
depannya_atau	depannya	atau	2
depannya_bagaimana	depannya	bagaimana	2
depannya_dirinya	depannya	dirinya	2
depannya_harus	depannya	harus	2
depannya_karena	depannya	karena	2
depannya_kemarin	depannya	kemarin	2
depannya_lagi	depannya	lagi	2
depannya_langkah	depannya	langkah	2
depannya_mampu	depannya	mampu	2
depannya_masuk	depannya	masuk	2
depannya_memang	depannya	memang	2
depannya_membuat	depannya	membuat	2
depannya_menjadi	depannya	menjadi	2
depannya_pihaknya	depannya	pihaknya	2
depannya_prestasi	depannya	prestasi	2
depannya_saat	depannya	saat	2
depannya_saja	depannya	saja	2
depannya_sendiri	depannya	sendiri	2
depannya_tapi	depannya	tapi	2
depannya_target	depannya	target	2
depannya_terang	depannya	terang	2
depannya_terdapat	depannya	terdapat	2
depannya_terlepas	depannya	terlepas	2
depannya_termasuk	depannya	termasuk	2
depannya_tim	depannya	tim	2
deretan_terdepan	deretan	terdepan	2
di_depanku	di	depanku	2
di_depanya	di	depanya	2
di_tengah-depan	di	tengah-depan	2
dia_mengedepankan	dia	mengedepankan	2
didepan_dan	didepan	dan	2
didepan_rumah	didepan	rumah	2
diharapkan_mengedepankan	diharapkan	mengedepankan	2
dikedepankan_di	dikedepankan	di	2
dikedepankan_ialah	dikedepankan	ialah	2
dikedepankan_karena	dikedepankan	karena	2
dikedepankan_oleh	dikedepankan	oleh	2
dikedepankan_yakni	dikedepankan	yakni	2
dinding_depan	dinding	depan	2
finish_terdepan	finish	terdepan	2
front_terdepan	front	terdepan	2
gerbang_terdepan	gerbang	terdepan	2
gigi_depan	gigi	depan	2
gril_depan	gril	depan	2
grille_depan	grille	depan	2
harapkan_kedepannya	harapkan	kedepannya	2
harus_mengedepan-kan	harus	mengedepan-kan	2
harus_terdepan	harus	terdepan	2
huruf_depan	huruf	depan	2
indepanden_ini	indepanden	ini	2
ingin_kedepannya	ingin	kedepannya	2
jauh_kedepan	jauh	kedepan	2
justru_mengedepankan	justru	mengedepankan	2
kami_mengedepankan	kami	mengedepankan	2
karena_kedepannya	karena	kedepannya	2
kawasan_depan	kawasan	depan	2
kedepan_ada	kedepan	ada	2
kedepan_di	kedepan	di	2
kedepan_dirinya	kedepan	dirinya	2
kedepan_hingga	kedepan	hingga	2
kedepan_ini	kedepan	ini	2
kedepan_juga	kedepan	juga	2
kedepan_karena	kedepan	karena	2
kedepan_kegiatan	kedepan	kegiatan	2
kedepan_nantinya	kedepan	nantinya	2
kedepan_papar	kedepan	papar	2
kedepan_pasti	kedepan	pasti	2
kedepan_program	kedepan	program	2
kedepan_sangat	kedepan	sangat	2
kedepan_semua	kedepan	semua	2
kedepan_serta	kedepan	serta	2
kedepan_tandas	kedepan	tandas	2
kedepan_ucap	kedepan	ucap	2
kedepan_yakni	kedepan	yakni	2
kedepannya_ada	kedepannya	ada	2
kedepannya_adalah	kedepannya	adalah	2
kedepannya_banyak	kedepannya	banyak	2
kedepannya_di	kedepannya	di	2
kedepannya_imbuh	kedepannya	imbuh	2
kedepannya_khususnya	kedepannya	khususnya	2
kedepannya_kita	kedepannya	kita	2
kedepannya_melalui	kedepannya	melalui	2
kedepannya_mereka	kedepannya	mereka	2
kedepannya_pihaknya	kedepannya	pihaknya	2
kedepannya_semakin	kedepannya	semakin	2
kedepannya_ujarnya	kedepannya	ujarnya	2
kita_kedepan	kita	kedepan	2
kontroversial_mengedepankan	kontroversial	mengedepankan	2
latar_depan	latar	depan	2
lebih_mengedepan-kan	lebih	mengedepan-kan	2
leher_depan	leher	depan	2
lokasi_depan	lokasi	depan	2
loket_depan	loket	depan	2
maka_kedepan	maka	kedepan	2
martir_terdepan	martir	terdepan	2
masyarakat_mengedepankan	masyarakat	mengedepankan	2
medan_terdepan	medan	terdepan	2
menatap_kedepan	menatap	kedepan	2
mengatakan_kedepan	mengatakan	kedepan	2
menge-depankan_kualitas	menge-depankan	kualitas	2
mengedepan_dalam	mengedepan	dalam	2
mengedepan_dari	mengedepan	dari	2
mengedepankan_aspirasi	mengedepankan	aspirasi	2
mengedepankan_azas	mengedepankan	azas	2
mengedepankan_bahwa	mengedepankan	bahwa	2
mengedepankan_budaya	mengedepankan	budaya	2
mengedepankan_demokrasi	mengedepankan	demokrasi	2
mengedepankan_desain	mengedepankan	desain	2
mengedepankan_dialog	mengedepankan	dialog	2
mengedepankan_emosional	mengedepankan	emosional	2
mengedepankan_empat	mengedepankan	empat	2
mengedepankan_gaya	mengedepankan	gaya	2
mengedepankan_hak-hak	mengedepankan	hak-hak	2
mengedepankan_hati	mengedepankan	hati	2
mengedepankan_hegemoni	mengedepankan	hegemoni	2
mengedepankan_iman	mengedepankan	iman	2
mengedepankan_integritas	mengedepankan	integritas	2
mengedepankan_kaidah	mengedepankan	kaidah	2
mengedepankan_kemajuan	mengedepankan	kemajuan	2
mengedepankan_kepen-tingan	mengedepankan	kepen-tingan	2
mengedepankan_kerja	mengedepankan	kerja	2
mengedepankan_kesantunan	mengedepankan	kesantunan	2
mengedepankan_kesatuan	mengedepankan	kesatuan	2
mengedepankan_kesehatan	mengedepankan	kesehatan	2
mengedepankan_keuntungan	mengedepankan	keuntungan	2
mengedepankan_pada	mengedepankan	pada	2
mengedepankan_pemahaman	mengedepankan	pemahaman	2
mengedepankan_pemberdayaan	mengedepankan	pemberdayaan	2
mengedepankan_penataan	mengedepankan	penataan	2
mengedepankan_penegakan	mengedepankan	penegakan	2
mengedepankan_peningkatan	mengedepankan	peningkatan	2
mengedepankan_peran	mengedepankan	peran	2
mengedepankan_persaingan	mengedepankan	persaingan	2
mengedepankan_prestasi	mengedepankan	prestasi	2
mengedepankan_safety	mengedepankan	safety	2
mengedepankan_sejumlah	mengedepankan	sejumlah	2
mengedepankan_skala	mengedepankan	skala	2
mengedepankan_tokoh-tokoh	mengedepankan	tokoh-tokoh	2
mengedepankan_tugas	mengedepankan	tugas	2
mengedepankan_visi	mengedepankan	visi	2
mengharapkan_kedepan	mengharapkan	kedepan	2
mereka_kedepankan	mereka	kedepankan	2
mini_depan	mini	depan	2
mulai_depan	mulai	depan	2
mulai_terdepan	mulai	terdepan	2
namun_kedepan	namun	kedepan	2
negara_terdepan	negara	terdepan	2
paha_depan	paha	depan	2
paling_terdepan	paling	terdepan	2
panggung_depan	panggung	depan	2
pantai_depan	pantai	depan	2
parkir_depan	parkir	depan	2
pemain-pemain_depan	pemain-pemain	depan	2
pemerintah_mengedepankan	pemerintah	mengedepankan	2
penantang_terdepan	penantang	terdepan	2
penting_dikedepankan	penting	dikedepankan	2
pergola_depan	pergola	depan	2
perlu_dikedepankan	perlu	dikedepankan	2
pertama_mengedepankan	pertama	mengedepankan	2
pertandingan_kedepan	pertandingan	kedepan	2
pertigaan_depan	pertigaan	depan	2
program_kedepan	program	kedepan	2
saf_terdepan	saf	terdepan	2
saya_mengedepankan	saya	mengedepankan	2
se-lalu_mengedepankan	se-lalu	mengedepankan	2
seharusnya_dikedepankan	seharusnya	dikedepankan	2
selasar_depan	selasar	depan	2
sepanjang_depan	sepanjang	depan	2
setahun_kedepan	setahun	kedepan	2
sudah_mengedepankan	sudah	mengedepankan	2
sudut_depan	sudut	depan	2
taman_depan	taman	depan	2
tampil_ter-depan	tampil	ter-depan	2
tampilan_depan	tampilan	depan	2
tapi_mengedepankan	tapi	mengedepankan	2
telah_mengedepankan	telah	mengedepankan	2
tembok_depan	tembok	depan	2
tenda_depan	tenda	depan	2
tengah-depan_masjid	tengah-depan	masjid	2
ter-depan_dalam	ter-depan	dalam	2
terdalam_terdepan	terdalam	terdepan	2
terdepan_ada	terdepan	ada	2
terdepan_dari	terdepan	dari	2
terdepan_itu	terdepan	itu	2
terdepan_kembali	terdepan	kembali	2
terdepan_lainnya	terdepan	lainnya	2
terdepan_mempertahankan	terdepan	mempertahankan	2
terdepan_namun	terdepan	namun	2
terdepan_perangi	terdepan	perangi	2
terdepan_sebanyak	terdepan	sebanyak	2
terdepan_sepanjang	terdepan	sepanjang	2
terdepan_setelah	terdepan	setelah	2
terdepan_yaitu	terdepan	yaitu	2
terdepan_yakni	terdepan	yakni	2
tertinggal_terdepan	tertinggal	terdepan	2
terus_dikedepankan	terus	dikedepankan	2
tetap_mengedepan-kan	tetap	mengedepan-kan	2
tetapi_mengedepankan	tetapi	mengedepankan	2
tiga_depan	tiga	depan	2
tim_terdepan	tim	terdepan	2
tombak_terdepan	tombak	terdepan	2
ujung_depan	ujung	depan	2
untuk_kedepannya	untuk	kedepannya	2
upaya_mengedepankan	upaya	mengedepankan	2
wajah_depan	wajah	depan	2
yakni_depan	yakni	depan	2
yang_kedepan	yang	kedepan	2
ada_kedepan	ada	kedepan	1
ada-lah_depan	ada-lah	depan	1
adalah_me-ngedepankan	adalah	me-ngedepankan	1
adalah_menge-depankan	adalah	menge-depankan	1
agar_depan	agar	depan	1
agar_kedepan-nya	agar	kedepan-nya	1
air_kedepannya	air	kedepannya	1
akan_menge-depankan	akan	menge-depankan	1
algoritma_terdepan	algoritma	terdepan	1
anak-anak_kedepannya	anak-anak	kedepannya	1
anda_kedepankan	anda	kedepankan	1
andalan_terdepan	andalan	terdepan	1
anggar_kedepan	anggar	kedepan	1
anggota_indepanden	anggota	indepanden	1
antaranya_depan	antaranya	depan	1
apapun_kedepankan	apapun	kedepankan	1
aparat_ter-depan	aparat	ter-depan	1
arah_kedepan	arah	kedepan	1
arti_mengedepankan	arti	mengedepankan	1
atau_dikedepankan	atau	dikedepankan	1
atau_terdepan	atau	terdepan	1
aula_depan	aula	depan	1
ba-gian_depan	ba-gian	depan	1
bagaimana_mengedepankan	bagaimana	mengedepankan	1
bagain_depan	bagain	depan	1
bagus_kedepannya	bagus	kedepannya	1
bahan_kedepan	bahan	kedepan	1
bahwa_ke-depan	bahwa	ke-depan	1
bahwasanya_kedepan	bahwasanya	kedepan	1
baik_kedepan	baik	kedepan	1
baik_mengedepankan	baik	mengedepankan	1
bakal_didepan	bakal	didepan	1
bakal_mengedepankan	bakal	mengedepankan	1
bamper_depan	bamper	depan	1
ban_depanlah	ban	depanlah	1
ban_depanmu	ban	depanmu	1
ban_depannya	ban	depannya	1
bangsa_kedepan	bangsa	kedepan	1
bangun_kedepan	bangun	kedepan	1
bangunan_depan	bangunan	depan	1
banjir_kedepan	banjir	kedepan	1
baru_depan	baru	depan	1
bbenar-benar_dikedepankan	bbenar-benar	dikedepankan	1
bekerja_didepan	bekerja	didepan	1
belum_dikedepankan	belum	dikedepankan	1
benar-be-nar_mengedepankan	benar-be-nar	mengedepankan	1
benar-benar_mengedepankan	benar-benar	mengedepankan	1
benar-benar_terdepan	benar-benar	terdepan	1
benturan-benturan_kedepan	benturan-benturan	kedepan	1
ber-harap_ke-depan	ber-harap	ke-depan	1
ber-harap_kedepan	ber-harap	kedepan	1
berada_didepannya	berada	didepannya	1
berada_terdepan	berada	terdepan	1
beranda_terdepan	beranda	terdepan	1
berarti_kedepan	berarti	kedepan	1
berat_kedepannya	berat	kedepannya	1
berdam-pak_kedepan	berdam-pak	kedepan	1
bergerak_kedepannya	bergerak	kedepannya	1
berhari_depan	berhari	depan	1
berkembang_kedepannya	berkembang	kedepannya	1
berkomitmen_terdepan	berkomitmen	terdepan	1
berlaga_didepan	berlaga	didepan	1
berlangsung_didepan	berlangsung	didepan	1
berlari_kedepan	berlari	kedepan	1
bermotor_depan	bermotor	depan	1
bernama_depan	bernama	depan	1
berperan_terdepan	berperan	terdepan	1
bertanding_mengedepankan	bertanding	mengedepankan	1
besar_depan	besar	depan	1
besar_mengedepankan	besar	mengedepankan	1
bidang_depan	bidang	depan	1
bila_kedepannya	bila	kedepannya	1
bilik_depan	bilik	depan	1
bisa_menge-depankan	bisa	menge-depankan	1
bodi_depan	bodi	depan	1
bola_kedepan	bola	kedepan	1
buat_kedepan	buat	kedepan	1
buat_kedepannya	buat	kedepannya	1
bukaan_depan	bukaan	depan	1
bukan_mengedepankan	bukan	mengedepankan	1
bulan_depanJumat	bulan	depanJumat	1
bulan_depannya	bulan	depannya	1
bulan_kedepannya	bulan	kedepannya	1
bulan-bulan_depan	bulan-bulan	depan	1
bulan-bulan_kedepan	bulan-bulan	kedepan	1
bulang_kedepan	bulang	kedepan	1
center_terdepan	center	terdepan	1
co-ver_depan	co-ver	depan	1
contoh_kedepan	contoh	kedepan	1
cover_depan	cover	depan	1
daerah-daerah_terdepan	daerah-daerah	terdepan	1
dalam_kedepannya	dalam	kedepannya	1
dalam_menge-depankan	dalam	menge-depankan	1
dalamnya_mengedepankan	dalamnya	mengedepankan	1
dan_depannya	dan	depannya	1
dan_didepan	dan	didepan	1
dan_menge-depankan	dan	menge-depankan	1
dan_mengedepan-kan	dan	mengedepan-kan	1
dapat_dike-depankan	dapat	dike-depankan	1
dapat_me-ngedepankan	dapat	me-ngedepankan	1
dapur_depan	dapur	depan	1
dari_depannya	dari	depannya	1
de-ngan_mengedepankan	de-ngan	mengedepankan	1
dekade_kedepan	dekade	kedepan	1
dekat_depan	dekat	depan	1
demikian_kedepannya	demikian	kedepannya	1
dengan_depan	dengan	depan	1
dengan_megedepankan	dengan	megedepankan	1
depan_1,3MP	depan	1,3MP	1
depan_acara	depan	acara	1
depan_adakah	depan	adakah	1
depan_agaknya	depan	agaknya	1
depan_agen	depan	agen	1
depan_air	depan	air	1
depan_ajaknya	depan	ajaknya	1
depan_ajang	depan	ajang	1
depan_ak-tivitas	depan	ak-tivitas	1
depanâ€_akan	depanâ€	akan	1
depan_akhir	depan	akhir	1
depan_akhirnya	depan	akhirnya	1
depan_akselerasi	depan	akselerasi	1
depan_aksi	depan	aksi	1
depan_akti-vitas	depan	akti-vitas	1
depan_alangkah	depan	alangkah	1
depan_alat	depan	alat	1
depan_alokasi	depan	alokasi	1
depan_anda	depan	anda	1
depan_anggar	depan	anggar	1
depan_angin	depan	angin	1
depan_angka	depan	angka	1
depan_angkatan	depan	angkatan	1
depan_apakah	depan	apakah	1
depan_apalah	depan	apalah	1
depan_aparatur	depan	aparatur	1
depan_api	depan	api	1
depan_aplikasi	depan	aplikasi	1
depan_arah	depan	arah	1
depan_arena	depan	arena	1
depan_arus	depan	arus	1
depan_aset	depan	aset	1
depan_aspirasi	depan	aspirasi	1
depan_atas	depan	atas	1
depan_ataupun	depan	ataupun	1
depan_aturan	depan	aturan	1
depan_audien	depan	audien	1
depan_audiens	depan	audiens	1
depan_aus	depan	aus	1
depan_awali	depan	awali	1
depan_ayahnya	depan	ayahnya	1
depan_ba-gaimana	depan	ba-gaimana	1
depan_bagus	depan	bagus	1
depan_baiknya	depan	baiknya	1
depan_bajaj	depan	bajaj	1
depan_baju	depan	baju	1
depan_bak	depan	bak	1
depan_balairung	depan	balairung	1
depan_baliho	depan	baliho	1
depan_ban	depan	ban	1
depan_bangsanya	depan	bangsanya	1
depan_bangunan-bangunan	depan	bangunan-bangunan	1
depan_bantuan	depan	bantuan	1
depan_barel	depan	barel	1
depan_basis	depan	basis	1
depan_batik	depan	batik	1
depan_bayi	depan	bayi	1
depan_bebas	depan	bebas	1
depan_beberapa	depan	beberapa	1
depan_bek	depan	bek	1
depan_bekas	depan	bekas	1
depan_ben-tuknnya	depan	ben-tuknnya	1
depan_bengkelnya	depan	bengkelnya	1
depan_bentor	depan	bentor	1
depan_ber-sama	depan	ber-sama	1
depan_ber-sama-sama	depan	ber-sama-sama	1
depan_ber-tempat	depan	ber-tempat	1
depan_berakibat	depan	berakibat	1
depan_berapa	depan	berapa	1
depan_berarti	depan	berarti	1
depan_berbangsa	depan	berbangsa	1
depan_berbentuk	depan	berbentuk	1
depan_berdasakan	depan	berdasakan	1
depan_beresolusi	depan	beresolusi	1
depan_bergoyang	depan	bergoyang	1
depan_berjumlah	depan	berjumlah	1
depan_berkaitan	depan	berkaitan	1
depan_berkasnya	depan	berkasnya	1
depan_berlambang	depan	berlambang	1
depan_berlanjut	depan	berlanjut	1
depan_bermaterikan	depan	bermaterikan	1
depan_beroperasi	depan	beroperasi	1
depan_berorientasi	depan	berorientasi	1
depan_berpo-tensi	depan	berpo-tensi	1
depan_bersanding	depan	bersanding	1
depan_bersensor	depan	bersensor	1
depan_bertatap	depan	bertatap	1
depan_berteknologi	depan	berteknologi	1
depan_bertempat	depan	bertempat	1
depan_bertemu	depan	bertemu	1
depan_berterali	depan	berterali	1
depan_berukuran	depan	berukuran	1
depan_berupa	depan	berupa	1
depan_besar	depan	besar	1
depan_bibit-bibit	depan	bibit-bibit	1
depan_bidang	depan	bidang	1
depan_bisnis	depan	bisnis	1
depan_bivak	depan	bivak	1
depan_blus	depan	blus	1
depan_bocah	depan	bocah	1
depan_boleh	depan	boleh	1
depan_bonus	depan	bonus	1
depan_bu-kan	depan	bu-kan	1
depan_bu-nga	depan	bu-nga	1
depan_budaya	depan	budaya	1
depan_buku	depan	buku	1
depan_bulutangkis	depan	bulutangkis	1
depan_bumper	depan	bumper	1
depan_buyers	depan	buyers	1
depan_cabin	depan	cabin	1
depan_calon-calon	depan	calon-calon	1
depan_candi	depan	candi	1
depan_capaian	depan	capaian	1
depan_celana	depan	celana	1
depan_cemerlang	depan	cemerlang	1
depan_cenderung	depan	cenderung	1
depan_cu-kup	depan	cu-kup	1
depan_cukup	depan	cukup	1
depan_dadanya	depan	dadanya	1
depan_daerahnya	depan	daerahnya	1
depan_daging	depan	daging	1
depan_dam-pak	depan	dam-pak	1
depan_dapur	depan	dapur	1
depan_daripada	depan	daripada	1
depan_data	depan	data	1
depan_datang	depan	datang	1
depan_defisit	depan	defisit	1
depan_demokrasi	depan	demokrasi	1
depan_denganbaik	depan	denganbaik	1
depan_dengannya	depan	dengannya	1
depan_depan	depan	depan	1
depan_desain	depan	desain	1
depan_design	depan	design	1
depan_di-harapkan	depan	di-harapkan	1
depan_dialognya	depan	dialognya	1
depan_dialokasikan	depan	dialokasikan	1
depan_diambil	depan	diambil	1
depan_diantaranya	depan	diantaranya	1
depan_diapit	depan	diapit	1
depan_diarahkan	depan	diarahkan	1
depan_diaspora	depan	diaspora	1
depan_dibiarkan	depan	dibiarkan	1
depan_dibicarakan	depan	dibicarakan	1
depan_dibikinkan	depan	dibikinkan	1
depan_dibuka	depan	dibuka	1
depan_dicukur	depan	dicukur	1
depan_difo-kuskan	depan	difo-kuskan	1
depan_difungsikan	depan	difungsikan	1
depan_digunakan	depan	digunakan	1
depan_diisi	depan	diisi	1
depan_dijadwalkan	depan	dijadwalkan	1
depan_dikatakannya	depan	dikatakannya	1
depan_dikelilingi	depan	dikelilingi	1
depan_dikembangkan	depan	dikembangkan	1
depan_dimanfaatkan	depan	dimanfaatkan	1
depan_dimu-lai	depan	dimu-lai	1
depan_dimungkinkan	depan	dimungkinkan	1
depan_dipatok	depan	dipatok	1
depan_dipenuhi	depan	dipenuhi	1
depan_diperbanyak	depan	diperbanyak	1
depan_diperkuat	depan	diperkuat	1
depan_diperlu-kan	depan	diperlu-kan	1
depan_diproyeksikan	depan	diproyeksikan	1
depan_dirawatnya	depan	dirawatnya	1
depan_direncakan	depan	direncakan	1
depan_direncanakanakan	depan	direncanakanakan	1
depan_disamping	depan	disamping	1
depan_disarankan	depan	disarankan	1
depan_disebabkan	depan	disebabkan	1
depan_diselenggarakan	depan	diselenggarakan	1
depan_diserahkan	depan	diserahkan	1
depan_disidang	depan	disidang	1
depan_disuguhi	depan	disuguhi	1
depan_disulap	depan	disulap	1
depan_disumbang	depan	disumbang	1
depan_ditambah	depan	ditambah	1
depan_ditetapkan	depan	ditetapkan	1
depan_ditingaktkan	depan	ditingaktkan	1
depan_ditopang	depan	ditopang	1
depan_ditransfer	depan	ditransfer	1
depan_diumumkan	depan	diumumkan	1
depan_diupayakan	depan	diupayakan	1
depan_diusahakan	depan	diusahakan	1
depan_diyakini	depan	diyakini	1
depan_dokter	depan	dokter	1
depan_draft	depan	draft	1
depan_duo	depan	duo	1
depan_dynamic	depan	dynamic	1
depan_e-commerce	depan	e-commerce	1
depan_efek	depan	efek	1
depan_eks	depan	eks	1
depan_eks-eks	depan	eks-eks	1
depan_eksekutif	depan	eksekutif	1
depan_ekspor	depan	ekspor	1
depan_elit	depan	elit	1
depan_enam	depan	enam	1
depan_energi	depan	energi	1
depan_enggak	depan	enggak	1
depan_eranya	depan	eranya	1
depan_eskavator	depan	eskavator	1
depan_ex	depan	ex	1
depan_fasilitas	depan	fasilitas	1
depan_fenomena	depan	fenomena	1
depan_figur	depan	figur	1
depan_film-film	depan	film-film	1
depan_finansial	depan	finansial	1
depan_fisik	depan	fisik	1
depan_fit	depan	fit	1
depan_fitur	depan	fitur	1
depan_galeri	depan	galeri	1
depan_garasi	depan	garasi	1
depan_ge-nerasi	depan	ge-nerasi	1
depan_gelandang	depan	gelandang	1
depan_gelar	depan	gelar	1
depan_gelombang	depan	gelombang	1
depan_gift	depan	gift	1
depan_gong	depan	gong	1
depan_grill	depan	grill	1
depan_gua	depan	gua	1
depan_gudep	depan	gudep	1
depan_gundul	depan	gundul	1
depan_ha-rus	depan	ha-rus	1
depan_hampir	depan	hampir	1
depan_hanggar	depan	hanggar	1
depan_harap	depan	harap	1
depan_harapannya	depan	harapannya	1
depan_harian	depan	harian	1
depan_harus-nya	depan	harus-nya	1
depan_haruslah	depan	haruslah	1
depan_hati	depan	hati	1
depan_headwind	depan	headwind	1
depan_hendaknya	depan	hendaknya	1
depan_hewan	depan	hewan	1
depan_honor	depan	honor	1
depan_honorer	depan	honorer	1
depan_hubungannya	depan	hubungannya	1
depan_huruf	depan	huruf	1
depan_hutan-hutan	depan	hutan-hutan	1
depan_i-road	depan	i-road	1
depan_ialah	depan	ialah	1
depan_ibu	depan	ibu	1
depan_ibunya	depan	ibunya	1
depan_idealnya	depan	idealnya	1
depan_ikutan	depan	ikutan	1
depan_ilmu	depan	ilmu	1
depan_ilmuwan	depan	ilmuwan	1
depan_imajiner	depan	imajiner	1
depan_imperialis	depan	imperialis	1
depan_imunitas	depan	imunitas	1
depan_inci	depan	inci	1
depan_individu	depan	individu	1
depan_infrastruktur	depan	infrastruktur	1
depan_inginnya	depan	inginnya	1
depan_insan	depan	insan	1
depan_insentif	depan	insentif	1
depan_institusi	depan	institusi	1
depan_institusinya	depan	institusinya	1
depan_integrasi	depan	integrasi	1
depan_internet	depan	internet	1
depan_istanah	depan	istanah	1
depan_iya	depan	iya	1
depan_jabatan	depan	jabatan	1
depan_jalulr	depan	jalulr	1
depan_janji	depan	janji	1
depan_jarang	depan	jarang	1
depan_jargon	depan	jargon	1
depan_jaringan	depan	jaringan	1
depan_jawabnya	depan	jawabnya	1
depan_jemaah	depan	jemaah	1
depan_jihad	depan	jihad	1
depan_jo	depan	jo	1
depan_junio	depan	junio	1
depan_jurijuri	depan	jurijuri	1
depan_jurnalisme	depan	jurnalisme	1
depan_justru	depan	justru	1
depan_ka-rena	depan	ka-rena	1
depan_ka-wasan	depan	ka-wasan	1
depan_ka'bah	depan	ka'bah	1
depan_kacamatanya	depan	kacamatanya	1
depan_kain	depan	kain	1
depan_kajian	depan	kajian	1
depan_kakeknya	depan	kakeknya	1
depan_kam-pus	depan	kam-pus	1
depan_kam-pusnya	depan	kam-pusnya	1
depan_kamu	depan	kamu	1
depan_kan-tornya	depan	kan-tornya	1
depan_kanan-nya	depan	kanan-nya	1
depan_kanpus	depan	kanpus	1
depan_kapal	depan	kapal	1
depan_kapal-kapal	depan	kapal-kapal	1
depan_kapasitas	depan	kapasitas	1
depan_karavan	depan	karavan	1
depan_kariernya	depan	kariernya	1
depan_karir	depan	karir	1
depan_karirnya	depan	karirnya	1
depan_karnaval	depan	karnaval	1
depan_kart	depan	kart	1
depan_karyanya	depan	karyanya	1
depan_karyawan	depan	karyawan	1
depan_kasir	depan	kasir	1
depan_katakanlah	depan	katakanlah	1
depan_kateringnya	depan	kateringnya	1
depan_kaum	depan	kaum	1
depan_kawan-kawan	depan	kawan-kawan	1
depan_ke-diaman	depan	ke-diaman	1
depan_ke-hadiran	depan	ke-hadiran	1
depan_ke-mudian	depan	ke-mudian	1
depan_keadaan	depan	keadaan	1
depan_kebaya	depan	kebaya	1
depan_kebe-tulan	depan	kebe-tulan	1
depan_keberhasilan	depan	keberhasilan	1
depan_kebhinekaan	depan	kebhinekaan	1
depan_kebijakan	depan	kebijakan	1
depan_kebun	depan	kebun	1
depan_kebutuhan	depan	kebutuhan	1
depan_kecamatan	depan	kecamatan	1
depan_kecukupan	depan	kecukupan	1
depan_kediamannya	depan	kediamannya	1
depan_kedodoran	depan	kedodoran	1
depan_kedubes	depan	kedubes	1
depan_keempat	depan	keempat	1
depan_kehidupan	depan	kehidupan	1
depan_keindonesiaan	depan	keindonesiaan	1
depan_keinginan	depan	keinginan	1
depan_kejadian	depan	kejadian	1
depan_kejaksaan	depan	kejaksaan	1
depan_kejari	depan	kejari	1
depan_kejuaraan	depan	kejuaraan	1
depan_kelangkaan	depan	kelangkaan	1
depan_kelasnya	depan	kelasnya	1
depan_kelengkapan	depan	kelengkapan	1
depan_kelistrikan	depan	kelistrikan	1
depan_kelompok	depan	kelompok	1
depan_kelurah-an	depan	kelurah-an	1
depan_kelurahan	depan	kelurahan	1
depan_kemajemukan	depan	kemajemukan	1
depan_kemandirian	depan	kemandirian	1
depan_kemitraan	depan	kemitraan	1
depan_kendala	depan	kendala	1
depan_kepala	depan	kepala	1
depan_kepengurusan	depan	kepengurusan	1
depan_keputusannya	depan	keputusannya	1
depan_kerap	depan	kerap	1
depan_kerbau	depan	kerbau	1
depan_kerjasama	depan	kerjasama	1
depan_kesalahan	depan	kesalahan	1
depan_kesayangan	depan	kesayangan	1
depan_kesehatan	depan	kesehatan	1
depan_kesejahteraan	depan	kesejahteraan	1
depan_kesempatan	depan	kesempatan	1
depan_kesuksesan	depan	kesuksesan	1
depan_keterkai-tan	depan	keterkai-tan	1
depan_keuntungan	depan	keuntungan	1
depan_kewenangan	depan	kewenangan	1
depan_khu-susnya	depan	khu-susnya	1
depan_ki-nerja	depan	ki-nerja	1
depan_kian	depan	kian	1
depan_kipas	depan	kipas	1
depan_kira-nya	depan	kira-nya	1
depan_klenteng	depan	klenteng	1
depan_klik	depan	klik	1
depan_ko-tak	depan	ko-tak	1
depan_komentar	depan	komentar	1
depan_komoditas	depan	komoditas	1
depan_konblok	depan	konblok	1
depan_konflik-konflik	depan	konflik-konflik	1
depan_konsumen	depan	konsumen	1
depan_kornea	depan	kornea	1
depan_kualitasnya	depan	kualitasnya	1
depan_kuartet	depan	kuartet	1
depan_kubunya	depan	kubunya	1
depan_kuburan	depan	kuburan	1
depan_kuil	depan	kuil	1
depan_kun-cinya	depan	kun-cinya	1
depan_kunci	depan	kunci	1
depan_kunci-nya	depan	kunci-nya	1
depan_kunjungan	depan	kunjungan	1
depan_kuota	depan	kuota	1
depan_kurang	depan	kurang	1
depan_kurban	depan	kurban	1
depan_kursi	depan	kursi	1
depan_kwartir	depan	kwartir	1
depan_laba	depan	laba	1
depan_lahir	depan	lahir	1
depan_lainnya	depan	lainnya	1
depan_lan-jut	depan	lan-jut	1
depan_langkah-langkah	depan	langkah-langkah	1
depan_lantai	depan	lantai	1
depan_laptop	depan	laptop	1
depan_larangan	depan	larangan	1
depan_latihan	depan	latihan	1
depan_latihannya	depan	latihannya	1
depan_laut	depan	laut	1
depan_lawan-lawannya	depan	lawan-lawannya	1
depan_layaknya	depan	layaknya	1
depan_leher	depan	leher	1
depan_lepas	depan	lepas	1
depan_lift	depan	lift	1
depan_lobby	depan	lobby	1
depan_lorong	depan	lorong	1
depan_loses	depan	loses	1
depan_lu-lusan	depan	lu-lusan	1
depan_luka	depan	luka	1
depan_lulus	depan	lulus	1
depan_maja-lah	depan	maja-lah	1
depan_majalah	depan	majalah	1
depan_maju	depan	maju	1
depan_makamnya	depan	makamnya	1
depan_makanya	depan	makanya	1
depan_maksimal	depan	maksimal	1
depan_maktab	depan	maktab	1
depan_malah	depan	malah	1
depan_mamuaja	depan	mamuaja	1
depan_mantan	depan	mantan	1
depan_mapolres	depan	mapolres	1
depan_mapolwil	depan	mapolwil	1
depan_markasnya	depan	markasnya	1
depan_mas	depan	mas	1
depan_masa-lah	depan	masa-lah	1
depan_masing-masing	depan	masing-masing	1
depan_maskapai	depan	maskapai	1
depan_massanya	depan	massanya	1
depan_masuk	depan	masuk	1
depan_mata-nya	depan	mata-nya	1
depan_maunya	depan	maunya	1
depan_me-ski	depan	me-ski	1
depan_medium	depan	medium	1
depan_mekanisme	depan	mekanisme	1
depan_melainkan	depan	melainkan	1
depan_melawan	depan	melawan	1
depan_melesak	depan	melesak	1
depan_mem-buat	depan	mem-buat	1
depan_mem-perhatikan	depan	mem-perhatikan	1
depan_memabik	depan	memabik	1
depan_memadati	depan	memadati	1
depan_memakai	depan	memakai	1
depan_memandu	depan	memandu	1
depan_memasuki	depan	memasuki	1
depan_mematuhi	depan	mematuhi	1
depan_membandingkan	depan	membandingkan	1
depan_membangkitkan	depan	membangkitkan	1
depan_membawa	depan	membawa	1
depan_memberikan	depan	memberikan	1
depan_membuat	depan	membuat	1
depan_memfokuskan	depan	memfokuskan	1
depan_meminta	depan	meminta	1
depan_mempelai	depan	mempelai	1
depan_memperkuat	depan	memperkuat	1
depan_memungkinkan	depan	memungkinkan	1
depan_men-cari	depan	men-cari	1
depan_menabung	depan	menabung	1
depan_menandakan	depan	menandakan	1
depan_menang	depan	menang	1
depan_menara	depan	menara	1
depan_menargetkan	depan	menargetkan	1
depan_mencari	depan	mencari	1
depan_mendaftarkan	depan	mendaftarkan	1
depan_mendapat	depan	mendapat	1
depan_mendatang	depan	mendatang	1
depan_mendukung	depan	mendukung	1
depan_mene-lusuri	depan	mene-lusuri	1
depan_menekan	depan	menekan	1
depan_menembus	depan	menembus	1
depan_menentukan	depan	menentukan	1
depan_meng-hadapi	depan	meng-hadapi	1
depan_meng-online-kan	depan	meng-online-kan	1
depan_mengacu	depan	mengacu	1
depan_mengambil	depan	mengambil	1
depan_mengenai	depan	mengenai	1
depan_menggantikan	depan	menggantikan	1
depan_menggebuk	depan	menggebuk	1
depan_menghadap	depan	menghadap	1
depan_menginter-nalisasikan	depan	menginter-nalisasikan	1
depan_mengkhawatirkan	depan	mengkhawatirkan	1
depan_mengkritisi	depan	mengkritisi	1
depan_mengungkapkan	depan	mengungkapkan	1
depan_mengutuk	depan	mengutuk	1
depan_mengutus	depan	mengutus	1
depan_menjelang	depan	menjelang	1
depan_menonjol	depan	menonjol	1
depan_menteri	depan	menteri	1
depan_menu-rutnya	depan	menu-rutnya	1
depan_menukangi	depan	menukangi	1
depan_menunggangi	depan	menunggangi	1
depan_menuntut	depan	menuntut	1
depan_menurun	depan	menurun	1
depan_menurutnya	depan	menurutnya	1
depan_menyala	depan	menyala	1
depan_menyalurkan	depan	menyalurkan	1
depan_menyerahkan	depan	menyerahkan	1
depan_menyusul	depan	menyusul	1
depan_mere-ka	depan	mere-ka	1
depan_mesin	depan	mesin	1
depan_mesin-mesin	depan	mesin-mesin	1
depan_mesinnya	depan	mesinnya	1
depan_meskipun	depan	meskipun	1
depan_mess	depan	mess	1
depan_mesti	depan	mesti	1
depan_mic	depan	mic	1
depan_militer	depan	militer	1
depan_minibus	depan	minibus	1
depan_minimal	depan	minimal	1
depan_mirip	depan	mirip	1
depan_mitra	depan	mitra	1
depan_mo	depan	mo	1
depan_mo-bil	depan	mo-bil	1
depan_mobnas	depan	mobnas	1
depan_moncong	depan	moncong	1
depan_monitor	depan	monitor	1
depan_monumen	depan	monumen	1
depan_motivasi	depan	motivasi	1
depan_motornya	depan	motornya	1
depan_mudik	depan	mudik	1
depan_muka	depan	muka	1
depan_mulainya	depan	mulainya	1
depan_mumpung	depan	mumpung	1
depan_murid-muridnya	depan	murid-muridnya	1
depan_mus-da	depan	mus-da	1
depan_musala	depan	musala	1
depan_mushala	depan	mushala	1
depan_mushalla	depan	mushalla	1
depan_musim	depan	musim	1
depan_mustahil	depan	mustahil	1
depan_na-mun	depan	na-mun	1
depan_nahasnya	depan	nahasnya	1
depan_namanya	depan	namanya	1
depan_nan-tinya	depan	nan-tinya	1
depan_nangkring	depan	nangkring	1
depan_nanti-nya	depan	nanti-nya	1
depan_nasib	depan	nasib	1
depan_negaranya	depan	negaranya	1
depan_nege-rinya	depan	nege-rinya	1
depan_ngarai	depan	ngarai	1
depan_nggak	depan	nggak	1
depan_notaris	depan	notaris	1
depan_olehnya	depan	olehnya	1
depan_ompong	depan	ompong	1
depan_operasi	depan	operasi	1
depan_operator	depan	operator	1
depan_optimalisasi	depan	optimalisasi	1
depan_optimistis	depan	optimistis	1
depan_orang-orang	depan	orang-orang	1
depan_orientasi	depan	orientasi	1
depan_outlet	depan	outlet	1
depan_pa-ra	depan	pa-ra	1
depan_pacaran	depan	pacaran	1
depan_padang	depan	padang	1
depan_pahlawan	depan	pahlawan	1
depan_pajak	depan	pajak	1
depan_pajangan	depan	pajangan	1
depan_paket	depan	paket	1
depan_pamer	depan	pamer	1
depan_pang-gung	depan	pang-gung	1
depan_panggilan	depan	panggilan	1
depan_pangsa	depan	pangsa	1
depan_panitia	depan	panitia	1
depan_pansus	depan	pansus	1
depan_parfumnya	depan	parfumnya	1
depan_parpol	depan	parpol	1
depan_partisipasi	depan	partisipasi	1
depan_pasa-ngan	depan	pasa-ngan	1
depan_pascadua	depan	pascadua	1
depan_pascakedatangan	depan	pascakedatangan	1
depan_pascapelimpahan	depan	pascapelimpahan	1
depan_pasokan	depan	pasokan	1
depan_pastori	depan	pastori	1
depan_pasukannya	depan	pasukannya	1
depan_patah	depan	patah	1
depan_payung	depan	payung	1
depan_pe-nilaian	depan	pe-nilaian	1
depan_pedukung	depan	pedukung	1
depan_pegawai	depan	pegawai	1
depan_pekerjaan	depan	pekerjaan	1
depan_pekerjaannya	depan	pekerjaannya	1
depan_pelabuhan	depan	pelabuhan	1
depan_pelaksana	depan	pelaksana	1
depan_pelaksanaan	depan	pelaksanaan	1
depan_pelaku	depan	pelaku	1
depan_pelantikan	depan	pelantikan	1
depan_pelayan-an	depan	pelayan-an	1
depan_pelayanan	depan	pelayanan	1
depan_peluang	depan	peluang	1
depan_pem-bangunan	depan	pem-bangunan	1
depan_pemain-pemain	depan	pemain-pemain	1
depan_pemangku	depan	pemangku	1
depan_pembahasan	depan	pembahasan	1
depan_pembangun-an	depan	pembangun-an	1
depan_pembangunannya	depan	pembangunannya	1
depan_pembeli	depan	pembeli	1
depan_pembuatan	depan	pembuatan	1
depan_pemda	depan	pemda	1
depan_pemdes	depan	pemdes	1
depan_peme-rintah	depan	peme-rintah	1
depan_pemecahan	depan	pemecahan	1
depan_pemekaran	depan	pemekaran	1
depan_pemerataan	depan	pemerataan	1
depan_pemerin-tah	depan	pemerin-tah	1
depan_pemili-hannya	depan	pemili-hannya	1
depan_pemprov	depan	pemprov	1
depan_pemuda	depan	pemuda	1
depan_penambahan	depan	penambahan	1
depan_penarikan	depan	penarikan	1
depan_pencairan	depan	pencairan	1
depan_pencapaian	depan	pencapaian	1
depan_pendaftarannya	depan	pendaftarannya	1
depan_pendapa	depan	pendapa	1
depan_pendapatan	depan	pendapatan	1
depan_pendekatan	depan	pendekatan	1
depan_pendukung-nya	depan	pendukung-nya	1
depan_penegakan	depan	penegakan	1
depan_penenun	depan	penenun	1
depan_pengacara	depan	pengacara	1
depan_pengembang	depan	pengembang	1
depan_pengembangan	depan	pengembangan	1
depan_pengerahan	depan	pengerahan	1
depan_pengeras	depan	pengeras	1
depan_pengerjaannya	depan	pengerjaannya	1
depan_penggemar	depan	penggemar	1
depan_penghargaan	depan	penghargaan	1
depan_pengolahan	depan	pengolahan	1
depan_pengunjuk	depan	pengunjuk	1
depan_pengusaha	depan	pengusaha	1
depan_penyelenggaraan	depan	penyelenggaraan	1
depan_penyuluh	depan	penyuluh	1
depan_per	depan	per	1
depan_per-baikan	depan	per-baikan	1
depan_per-sekolahan	depan	per-sekolahan	1
depan_per-tarungan	depan	per-tarungan	1
depan_perahu	depan	perahu	1
depan_peranan	depan	peranan	1
depan_perangkat	depan	perangkat	1
depan_perban-kan	depan	perban-kan	1
depan_perbankan	depan	perbankan	1
depan_perbatasan	depan	perbatasan	1
depan_percaya	depan	percaya	1
depan_perdagangan	depan	perdagangan	1
depan_pereko-nomian	depan	pereko-nomian	1
depan_perekrutan	depan	perekrutan	1
depan_perencanaan	depan	perencanaan	1
depan_perfilman	depan	perfilman	1
depan_pergerakan	depan	pergerakan	1
depan_pergu-ruan	depan	pergu-ruan	1
depan_peringatan	depan	peringatan	1
depan_perkampungan	depan	perkampungan	1
depan_perlombaan	depan	perlombaan	1
depan_perolehan	depan	perolehan	1
depan_persaingan	depan	persaingan	1
depan_persekolahan	depan	persekolahan	1
depan_persen	depan	persen	1
depan_persentase	depan	persentase	1
depan_persiapan	depan	persiapan	1
depan_persida-ngan	depan	persida-ngan	1
depan_persma	depan	persma	1
depan_personel	depan	personel	1
depan_perspektif	depan	perspektif	1
depan_pertahanan	depan	pertahanan	1
depan_pertama	depan	pertama	1
depan_pertemuan	depan	pertemuan	1
depan_perumah-an	depan	perumah-an	1
depan_perumahan	depan	perumahan	1
depan_peruntukannya	depan	peruntukannya	1
depan_perutnya	depan	perutnya	1
depan_pesepakbola	depan	pesepakbola	1
depan_peta	depan	peta	1
depan_peti	depan	peti	1
depan_pewarta	depan	pewarta	1
depan_piano	depan	piano	1
depan_pikirkan	depan	pikirkan	1
depan_pintanya	depan	pintanya	1
depan_planet	depan	planet	1
depan_podium	depan	podium	1
depan_poliklinik	depan	poliklinik	1
depan_politeknik	depan	politeknik	1
depan_politiknya	depan	politiknya	1
depan_politisi	depan	politisi	1
depan_pom	depan	pom	1
depan_pompa	depan	pompa	1
depan_porsinya	depan	porsinya	1
depan_posko	depan	posko	1
depan_prajurit	depan	prajurit	1
depan_praktisi	depan	praktisi	1
depan_presen-tasi	depan	presen-tasi	1
depan_pro-gram	depan	pro-gram	1
depan_produktivitas	depan	produktivitas	1
depan_propinsi	depan	propinsi	1
depan_prosesnya	depan	prosesnya	1
depan_prospek	depan	prospek	1
depan_prototipenya	depan	prototipenya	1
depan_provinsi	depan	provinsi	1
depan_proyek-proyek	depan	proyek-proyek	1
depan_psikotes	depan	psikotes	1
depan_pu-blik	depan	pu-blik	1
depan_pu-bliknya	depan	pu-bliknya	1
depan_pu-sat-pusat	depan	pu-sat-pusat	1
depan_publik-nya	depan	publik-nya	1
depan_pukul	depan	pukul	1
depan_pulau	depan	pulau	1
depan_pulau-pulau	depan	pulau-pulau	1
depan_pung-kas	depan	pung-kas	1
depan_punya	depan	punya	1
depan_puskesmas	depan	puskesmas	1
depan_quo	depan	quo	1
depan_raja	depan	raja	1
depan_rakyatnya	depan	rakyatnya	1
depan_ramai	depan	ramai	1
depan_rambut	depan	rambut	1
depan_rampung	depan	rampung	1
depan_rapur	depan	rapur	1
depan_rasa	depan	rasa	1
depan_rasanya	depan	rasanya	1
depan_rasio	depan	rasio	1
depan_realisasi	depan	realisasi	1
depan_regu	depan	regu	1
depan_rekannya	depan	rekannya	1
depan_rekto-rat	depan	rekto-rat	1
depan_rencaananya	depan	rencaananya	1
depan_rencana	depan	rencana	1
depan_rencanakan	depan	rencanakan	1
depan_renovasi	depan	renovasi	1
depan_resolusi	depan	resolusi	1
depan_resto	depan	resto	1
depan_restoran	depan	restoran	1
depan_rezim	depan	rezim	1
depan_ribu	depan	ribu	1
depan_rider	depan	rider	1
depan_riset	depan	riset	1
depan_ritel	depan	ritel	1
depan_roadmap	depan	roadmap	1
depan_roboh	depan	roboh	1
depan_rolling	depan	rolling	1
depan_rombongan	depan	rombongan	1
depan_rua-ngan	depan	rua-ngan	1
depan_rujab	depan	rujab	1
depan_rupiah	depan	rupiah	1
depan_sa-ya	depan	sa-ya	1
depan_saksi	depan	saksi	1
depan_saluran	depan	saluran	1
depan_sanggup	depan	sanggup	1
depan_santrinya	depan	santrinya	1
depan_sarana	depan	sarana	1
depan_se-cara	depan	se-cara	1
depan_se-jumlah	depan	se-jumlah	1
depan_se-karang	depan	se-karang	1
depan_seabrek	depan	seabrek	1
depan_seandainya	depan	seandainya	1
depan_seba-gaimana	depan	seba-gaimana	1
depan_sebagaimana	depan	sebagaimana	1
depan_sebe-lah	depan	sebe-lah	1
depan_sebisa	depan	sebisa	1
depan_sebutnya	depan	sebutnya	1
depan_sector	depan	sector	1
depan_segala	depan	segala	1
depan_sejak	depan	sejak	1
depan_sejalan	depan	sejalan	1
depan_sejarah	depan	sejarah	1
depan_sejauh	depan	sejauh	1
depan_sekalian	depan	sekalian	1
depan_sekelompok	depan	sekelompok	1
depan_sekembalinya	depan	sekembalinya	1
depan_sekiranya	depan	sekiranya	1
depan_sel	depan	sel	1
depan_selangkah	depan	selangkah	1
depan_selepas	depan	selepas	1
depan_selip	depan	selip	1
depan_selu-ruh	depan	selu-ruh	1
depan_semangat	depan	semangat	1
depan_sembilan	depan	sembilan	1
depan_semen	depan	semen	1
depan_sendiri	depan	sendiri	1
depan_sentra	depan	sentra	1
depan_sepanjang	depan	sepanjang	1
depan_sepeninggal	depan	sepeninggal	1
depan_serah	depan	serah	1
depan_serahkanlah	depan	serahkanlah	1
depan_seribuan	depan	seribuan	1
depan_sertifikat	depan	sertifikat	1
depan_setara	depan	setara	1
depan_seusai	depan	seusai	1
depan_si	depan	si	1
depan_siap-siap	depan	siap-siap	1
depan_siapa	depan	siapa	1
depan_sidangnya	depan	sidangnya	1
depan_siklus	depan	siklus	1
depan_simpang	depan	simpang	1
depan_simposium	depan	simposium	1
depan_sindir	depan	sindir	1
depan_sini	depan	sini	1
depan_skuat	depan	skuat	1
depan_skuatnya	depan	skuatnya	1
depan_smartphone	depan	smartphone	1
depan_so	depan	so	1
depan_soal	depan	soal	1
depan_sosialisasi	depan	sosialisasi	1
depan_sosok	depan	sosok	1
depan_speaker	depan	speaker	1
depan_spoiler	depan	spoiler	1
depan_spot	depan	spot	1
depan_stamina	depan	stamina	1
depan_stand	depan	stand	1
depan_standarnya	depan	standarnya	1
depan_start	depan	start	1
depan_statistik	depan	statistik	1
depan_stock	depan	stock	1
depan_strategi	depan	strategi	1
depan_striker	depan	striker	1
depan_su-permarket	depan	su-permarket	1
depan_suaminya	depan	suaminya	1
depan_subsidi	depan	subsidi	1
depan_suku	depan	suku	1
depan_supaya	depan	supaya	1
depan_supermarket	depan	supermarket	1
depan_suporternya	depan	suporternya	1
depan_suram	depan	suram	1
depan_tadi	depan	tadi	1
depan_tampa	depan	tampa	1
depan_tampilan	depan	tampilan	1
depan_tan-dasnya	depan	tan-dasnya	1
depan_tax	depan	tax	1
depan_te-patnya	depan	te-patnya	1
depan_telapak	depan	telapak	1
depan_teman-teman	depan	teman-teman	1
depan_tembok	depan	tembok	1
depan_tempat	depan	tempat	1
depan_tempat-tempat	depan	tempat-tempat	1
depan_tempatnya	depan	tempatnya	1
depan_tenant	depan	tenant	1
depan_tender	depan	tender	1
depan_tentang	depan	tentang	1
depan_tepat-nya	depan	tepat-nya	1
depan_terbinanya	depan	terbinanya	1
depan_tercapainya	depan	tercapainya	1
depan_terda-pat	depan	terda-pat	1
depan_terdiri	depan	terdiri	1
depan_terhadap	depan	terhadap	1
depan_terinal	depan	terinal	1
depan_terkekeh-kekeh	depan	terkekeh-kekeh	1
depan_terkunci	depan	terkunci	1
depan_terlahir	depan	terlahir	1
depan_terlalu	depan	terlalu	1
depan_terlebih	depan	terlebih	1
depan_terletak	depan	terletak	1
depan_terminalnya	depan	terminalnya	1
depan_terpantau	depan	terpantau	1
depan_tersenyum	depan	tersenyum	1
depan_terserah	depan	terserah	1
depan_tetunya	depan	tetunya	1
depan_tiap	depan	tiap	1
depan_timnas	depan	timnas	1
depan_ting-gal	depan	ting-gal	1
depan_tingkat	depan	tingkat	1
depan_tipe	depan	tipe	1
depan_tokoh	depan	tokoh	1
depan_tokoh-tokoh	depan	tokoh-tokoh	1
depan_tradisi	depan	tradisi	1
depan_transit	depan	transit	1
depan_tren	depan	tren	1
depan_tu	depan	tu	1
depan_tu-kasnya	depan	tu-kasnya	1
depan_tubuh	depan	tubuh	1
depan_tujuh	depan	tujuh	1
depan_tumbuh	depan	tumbuh	1
depan_tumbuhnya	depan	tumbuhnya	1
depan_tuntas	depan	tuntas	1
depan_tuntutan	depan	tuntutan	1
depan_turnamen	depan	turnamen	1
depan_turut	depan	turut	1
depan_tutup	depan	tutup	1
depan_uang	depan	uang	1
depan_ukuran	depan	ukuran	1
depan_ulama	depan	ulama	1
depan_ulas	depan	ulas	1
depan_ulasnya	depan	ulasnya	1
depan_ulos	depan	ulos	1
depan_umumkan	depan	umumkan	1
depan_undangan	depan	undangan	1
depan_unit	depan	unit	1
depan_universitas	depan	universitas	1
depan_upaya	depan	upaya	1
depan_urai	depan	urai	1
depan_usia	depan	usia	1
depan_usianya	depan	usianya	1
depan_utusan	depan	utusan	1
depan_via	depan	via	1
depan_volume	depan	volume	1
depan_vs	depan	vs	1
depan_wa-rung	depan	wa-rung	1
depan_wacana	depan	wacana	1
depan_wah	depan	wah	1
depan_wajib	depan	wajib	1
depan_walaupun	depan	walaupun	1
depan_wali	depan	wali	1
depan_walikota	depan	walikota	1
depan_warna	depan	warna	1
depan_warnet	depan	warnet	1
depan_wartel	depan	wartel	1
depan_warung-warung	depan	warung-warung	1
depan_waterpark	depan	waterpark	1
depan_wihara	depan	wihara	1
depan_wisatawan	depan	wisatawan	1
depan_x	depan	x	1
depan-baju_putih	depan-baju	putih	1
depan-belakang_dan	depan-belakang	dan	1
depan-depan_toko	depan-depan	toko	1
depan-nya_ajak	depan-nya	ajak	1
depan-nya_dengan	depan-nya	dengan	1
depan-nya_kita	depan-nya	kita	1
depan-nya_kontribusi	depan-nya	kontribusi	1
depan-nya_pintanya	depan-nya	pintanya	1
depan-nya_tidak	depan-nya	tidak	1
depang_ruang	depang	ruang	1
depankan_adu	depankan	adu	1
depankan_desain	depankan	desain	1
depanku_ketika	depanku	ketika	1
depanmu_sepanjang	depanmu	sepanjang	1
depannya_aktivitas	depannya	aktivitas	1
depannya_aku	depannya	aku	1
depannya_alat	depannya	alat	1
depannya_alat-alat	depannya	alat-alat	1
depannya_anak	depannya	anak	1
depannya_apa	depannya	apa	1
depannya_arah	depannya	arah	1
depannya_atlet	depannya	atlet	1
depannya_baik	depannya	baik	1
depannya_bakal	depannya	bakal	1
depannya_bang-sa	depannya	bang-sa	1
depannya_bank	depannya	bank	1
depannya_banyak	depannya	banyak	1
depannya_belum	depannya	belum	1
depannya_bentuk	depannya	bentuk	1
depannya_berbeda	depannya	berbeda	1
depannya_biar	depannya	biar	1
depannya_biaya	depannya	biaya	1
depannya_bila	depannya	bila	1
depannya_bisnis	depannya	bisnis	1
depannya_bukan	depannya	bukan	1
depannya_dalam	depannya	dalam	1
depannya_demikian	depannya	demikian	1
depannya_desa	depannya	desa	1
depannya_deteksi	depannya	deteksi	1
depannya_diberi	depannya	diberi	1
depannya_dibuang	depannya	dibuang	1
depannya_dibuat	depannya	dibuat	1
depannya_dijadikan	depannya	dijadikan	1
depannya_dikata-kan	depannya	dikata-kan	1
depannya_diperkirakan	depannya	diperkirakan	1
depannya_dirusak	depannya	dirusak	1
depannya_dise-diakan	depannya	dise-diakan	1
depannya_ditentukan	depannya	ditentukan	1
depannya_diupayakan	depannya	diupayakan	1
depannya_dua	depannya	dua	1
depannya_dynamic	depannya	dynamic	1
depannya_ekspor	depannya	ekspor	1
depannya_hancur	depannya	hancur	1
depannya_hanya	depannya	hanya	1
depannya_huruf	depannya	huruf	1
depannya_ia	depannya	ia	1
depannya_ingin	depannya	ingin	1
depannya_ini	depannya	ini	1
depannya_inilah	depannya	inilah	1
depannya_investor	depannya	investor	1
depannya_itu	depannya	itu	1
depannya_jadi	depannya	jadi	1
depannya_jangan	depannya	jangan	1
depannya_janji	depannya	janji	1
depannya_jelasnya	depannya	jelasnya	1
depannya_jumlah	depannya	jumlah	1
depannya_justru	depannya	justru	1
depannya_kalau	depannya	kalau	1
depannya_kawasan	depannya	kawasan	1
depannya_kedua	depannya	kedua	1
depannya_kegiatan	depannya	kegiatan	1
depannya_keputusan	depannya	keputusan	1
depannya_ketika	depannya	ketika	1
depannya_kiriman	depannya	kiriman	1
depannya_komunitas	depannya	komunitas	1
depannya_konsistensi	depannya	konsistensi	1
depannya_konsumer	depannya	konsumer	1
depannya_kualitas	depannya	kualitas	1
depannya_lang-sung	depannya	lang-sung	1
depannya_lewat	depannya	lewat	1
depannya_lily	depannya	lily	1
depannya_lima	depannya	lima	1
depannya_lulusan	depannya	lulusan	1
depannya_ma-sing-masing	depannya	ma-sing-masing	1
depannya_majelis	depannya	majelis	1
depannya_masyarakat	depannya	masyarakat	1
depannya_melalui	depannya	melalui	1
depannya_memasuki	depannya	memasuki	1
depannya_membantu	depannya	membantu	1
depannya_membentuk	depannya	membentuk	1
depannya_membutuhkan	depannya	membutuhkan	1
depannya_memiliki	depannya	memiliki	1
depannya_menghapuskan	depannya	menghapuskan	1
depannya_meskipun	depannya	meskipun	1
depannya_mungkin	depannya	mungkin	1
depannya_namun	depannya	namun	1
depannya_negara	depannya	negara	1
depannya_nIlai	depannya	nIlai	1
depannya_oleh	depannya	oleh	1
depannya_pabrik	depannya	pabrik	1
depannya_pada	depannya	pada	1
depannya_papar	depannya	papar	1
depannya_pasti	depannya	pasti	1
depannya_pecah	depannya	pecah	1
depannya_pelabuhan	depannya	pelabuhan	1
depannya_pelatihan	depannya	pelatihan	1
depannya_pemain	depannya	pemain	1
depannya_pembukaan	depannya	pembukaan	1
depannya_pemkot	depannya	pemkot	1
depannya_pemuda	depannya	pemuda	1
depannya_penerbangan	depannya	penerbangan	1
depannya_penerimaan	depannya	penerimaan	1
depannya_pengguna	depannya	pengguna	1
depannya_penuntasan	depannya	penuntasan	1
depannya_perlu	depannya	perlu	1
depannya_persaingan	depannya	persaingan	1
depannya_pertukaran	depannya	pertukaran	1
depannya_pesta	depannya	pesta	1
depannya_potensi	depannya	potensi	1
depannya_profesi	depannya	profesi	1
depannya_program-program	depannya	program-program	1
depannya_proses	depannya	proses	1
depannya_proyek	depannya	proyek	1
depannya_razia	depannya	razia	1
depannya_retak	depannya	retak	1
depannya_sambungnya	depannya	sambungnya	1
depannya_sangat	depannya	sangat	1
depannya_se-lip	depannya	se-lip	1
depannya_sebagai	depannya	sebagai	1
depannya_sebaiknya	depannya	sebaiknya	1
depannya_sebuah	depannya	sebuah	1
depannya_sekolah	depannya	sekolah	1
depannya_selalu	depannya	selalu	1
depannya_selama	depannya	selama	1
depannya_sementara	depannya	sementara	1
depannya_semoga	depannya	semoga	1
depannya_sepeda	depannya	sepeda	1
depannya_setiap	depannya	setiap	1
depannya_seusai	depannya	seusai	1
depannya_suhu	depannya	suhu	1
depannya_suster	depannya	suster	1
depannya_tadi	depannya	tadi	1
depannya_tandasnya	depannya	tandasnya	1
depannya_tanpa	depannya	tanpa	1
depannya_tegas	depannya	tegas	1
depannya_teknologi	depannya	teknologi	1
depannya_terhampar	depannya	terhampar	1
depannya_terkesan	depannya	terkesan	1
depannya_terpampang	depannya	terpampang	1
depannya_tersangka	depannya	tersangka	1
depannya_tertulis	depannya	tertulis	1
depannya_terutama	depannya	terutama	1
depannya_tiket	depannya	tiket	1
depannya_tutup	depannya	tutup	1
depannya_tuturnya	depannya	tuturnya	1
depannya_urai	depannya	urai	1
depannya_urainya	depannya	urainya	1
depannya_ya	depannya	ya	1
depannya_yaitu	depannya	yaitu	1
depanya_terbukti	depanya	terbukti	1
desa_depan	desa	depan	1
di_depan-belakang	di	depan-belakang	1
di_depan-depan	di	depan-depan	1
di_depan-nya	di	depan-nya	1
di_depang	di	depang	1
di_ke-depankan	di	ke-depankan	1
di-kedepankan_adalah	di-kedepankan	adalah	1
di-kedepankan_bukannya	di-kedepankan	bukannya	1
dia_depan	dia	depan	1
dia_kedepannya	dia	kedepannya	1
dibarisan_depan	dibarisan	depan	1
dibarisan_terdepan	dibarisan	terdepan	1
dibuatnya_mengedepankan	dibuatnya	mengedepankan	1
dicegat_depan	dicegat	depan	1
didepan_ada	didepan	ada	1
didepan_arrendisementsrechtbank	didepan	arrendisementsrechtbank	1
didepan_belum	didepan	belum	1
didepan_fans	didepan	fans	1
didepan_gawang	didepan	gawang	1
didepan_gerbang	didepan	gerbang	1
didepan_kotak	didepan	kotak	1
didepan_masyarakat	didepan	masyarakat	1
didepan_mereka	didepan	mereka	1
didepan_multimart	didepan	multimart	1
didepan_oleh	didepan	oleh	1
didepan_pengadilan	didepan	pengadilan	1
didepan_petugas	didepan	petugas	1
didepan_polisi	didepan	polisi	1
didepan_pusat	didepan	pusat	1
didepan_ribu	didepan	ribu	1
didepan_ribuan	didepan	ribuan	1
didepan_tersandung	didepan	tersandung	1
didepan_umum	didepan	umum	1
didepan_untuk	didepan	untuk	1
didepan_wakil	didepan	wakil	1
didepannya_dan	didepannya	dan	1
didepannya_dikenal	didepannya	dikenal	1
didepannya_langsung	didepannya	langsung	1
diha-rapkan_kedepan	diha-rapkan	kedepan	1
diharapkan_terdepan	diharapkan	terdepan	1
diharapkann_kedepannya	diharapkann	kedepannya	1
dijalankan_kedepannya	dijalankan	kedepannya	1
dijalankan_mengedepankan	dijalankan	mengedepankan	1
dike-depankan_jelasnya	dike-depankan	jelasnya	1
dikedepan-kan_dan	dikedepan-kan	dan	1
dikedepan-kan_pungkas	dikedepan-kan	pungkas	1
dikedepankan_ada-lah	dikedepankan	ada-lah	1
dikedepankan_agar	dikedepankan	agar	1
dikedepankan_ataukah	dikedepankan	ataukah	1
dikedepankan_bahkan	dikedepankan	bahkan	1
dikedepankan_bahwa	dikedepankan	bahwa	1
dikedepankan_baru	dikedepankan	baru	1
dikedepankan_bu-kan	dikedepankan	bu-kan	1
dikedepankan_bu-kannya	dikedepankan	bu-kannya	1
dikedepankan_bukan	dikedepankan	bukan	1
dikedepankan_dakwah-dakwah	dikedepankan	dakwah-dakwah	1
dikedepankan_demi	dikedepankan	demi	1
dikedepankan_dengan	dikedepankan	dengan	1
dikedepankan_hendaknya	dikedepankan	hendaknya	1
dikedepankan_imbau	dikedepankan	imbau	1
dikedepankan_ingatnya	dikedepankan	ingatnya	1
dikedepankan_kader	dikedepankan	kader	1
dikedepankan_kalau	dikedepankan	kalau	1
dikedepankan_kata	dikedepankan	kata	1
dikedepankan_langkah	dikedepankan	langkah	1
dikedepankan_menjadi	dikedepankan	menjadi	1
dikedepankan_pada	dikedepankan	pada	1
dikedepankan_papar	dikedepankan	papar	1
dikedepankan_pendekatan	dikedepankan	pendekatan	1
dikedepankan_polisi	dikedepankan	polisi	1
dikedepankan_sebagai	dikedepankan	sebagai	1
dikedepankan_sehingga	dikedepankan	sehingga	1
dikedepankan_sejumlah	dikedepankan	sejumlah	1
dikedepankan_so	dikedepankan	so	1
dikedepankan_tapi	dikedepankan	tapi	1
dikedepankan_tender	dikedepankan	tender	1
dikedepankan_terlebih	dikedepankan	terlebih	1
dikedepankan_tetapi	dikedepankan	tetapi	1
dikedepankan_tu-kasnya	dikedepankan	tu-kasnya	1
dikedepankan_ujar	dikedepankan	ujar	1
dikedepankan_ungkapnya	dikedepankan	ungkapnya	1
dikedepankan_untuk	dikedepankan	untuk	1
diketahui_didepan	diketahui	didepan	1
diklaim_mengedepankan	diklaim	mengedepankan	1
dilaksanakan_kedepan	dilaksanakan	kedepan	1
dilakukan_kedepan	dilakukan	kedepan	1
dilakukan_menge-depankan	dilakukan	menge-depankan	1
dilakukannya_kedepan	dilakukannya	kedepan	1
dilini_depan	dilini	depan	1
diluar_depan	diluar	depan	1
dinding-dinding_depan	dinding-dinding	depan	1
dipandang_ke-depan	dipandang	ke-depan	1
dipertahankan_kedepan	dipertahankan	kedepan	1
dipulihkan_kedepannya	dipulihkan	kedepannya	1
ditunggu-tunggu_kedepannya	ditunggu-tunggu	kedepannya	1
dituntut_didepan	dituntut	didepan	1
diunggah_menge-depankan	diunggah	menge-depankan	1
diupayakan_kedepannya	diupayakan	kedepannya	1
diusung_mengedepankan	diusung	mengedepankan	1
dosen-dosen_mengedepankan	dosen-dosen	mengedepankan	1
dua_depan	dua	depan	1
duduk_didepan	duduk	didepan	1
dulu_mengedepankan	dulu	mengedepankan	1
dunia_kedepan	dunia	kedepan	1
ekonomi_kedepan	ekonomi	kedepan	1
eksekusi_didepan	eksekusi	didepan	1
emas_kedepannya	emas	kedepannya	1
empat_depan	empat	depan	1
emper_depan	emper	depan	1
engedepankan_kepentingan	engedepankan	kepentingan	1
fasilitas_terdepan	fasilitas	terdepan	1
fender_depan	fender	depan	1
film_terdepan	film	terdepan	1
front_ter-depan	front	ter-depan	1
fu-turistik_kedepan	fu-turistik	kedepan	1
gambar_depan	gambar	depan	1
gapura_depan	gapura	depan	1
garda_depannya	garda	depannya	1
garda_ter-depan	garda	ter-depan	1
gardu_depan	gardu	depan	1
geladak_depan	geladak	depan	1
gelandang_depan	gelandang	depan	1
gender_dikedepankan	gender	dikedepankan	1
gerbang_depan	gerbang	depan	1
global_kedepannya	global	kedepannya	1
gol_didepan	gol	didepan	1
grid_terdepan	grid	terdepan	1
grup_terdepan	grup	terdepan	1
gugus_depannya	gugus	depannya	1
ha-nya_mengedepankan	ha-nya	mengedepankan	1
ha-rus_dikedepankan	ha-rus	dikedepankan	1
haji_depan	haji	depan	1
hala-man_depan	hala-man	depan	1
halamam_depan	halamam	depan	1
halaman_depannya	halaman	depannya	1
halaman-halaman_depan	halaman-halaman	depan	1
halte_depan	halte	depan	1
hanya_kedepankan	hanya	kedepankan	1
harapan_kedepannya	harapan	kedepannya	1
harus_di-kedepankan	harus	di-kedepankan	1
harus_dikedepan-kan	harus	dikedepan-kan	1
haruslah_dikedepankan	haruslah	dikedepankan	1
harusnya_dikedepankan	harusnya	dikedepankan	1
helm_depan	helm	depan	1
hen-daknya_mengedepankan	hen-daknya	mengedepankan	1
hidup_kedepan	hidup	kedepan	1
hingga_kedepannya	hingga	kedepannya	1
ia_mengedepankan	ia	mengedepankan	1
ikut_dikedepankan	ikut	dikedepankan	1
ikut_mengedepan	ikut	mengedepan	1
ikut_mengedepankan	ikut	mengedepankan	1
indepanden_atau	indepanden	atau	1
independensinya_di-kedepankan	independensinya	di-kedepankan	1
ini_dikedepankan	ini	dikedepankan	1
ini_terdepan	ini	terdepan	1
isu_kedepankan	isu	kedepankan	1
itu_me-ngedepankan	itu	me-ngedepankan	1
itu_mengedepan	itu	mengedepan	1
ja-lan_depan	ja-lan	depan	1
jalanan_depan	jalanan	depan	1
jam_kedepan	jam	kedepan	1
jangan_mengedepankan	jangan	mengedepankan	1
janji_didepan	janji	didepan	1
janji_mengedepankan	janji	mengedepankan	1
janji-janji_didepan	janji-janji	didepan	1
jauh_depan	jauh	depan	1
jelas_kedepannya	jelas	kedepannya	1
jika_kedepan	jika	kedepan	1
jika_kedepannya	jika	kedepannya	1
juga_depannya	juga	depannya	1
juga_dikedepankan	juga	dikedepankan	1
juga_kedepannya	juga	kedepannya	1
juga_mengedepanjan	juga	mengedepanjan	1
juga_terdepan	juga	terdepan	1
jurnal_kedepan	jurnal	kedepan	1
ka-wasan_depan	ka-wasan	depan	1
kabin_depan	kabin	depan	1
kabut_depan	kabut	depan	1
kader_kedepankan	kader	kedepankan	1
kali_menge-depan	kali	menge-depan	1
kampung_depan	kampung	depan	1
kandidat_terdepan	kandidat	terdepan	1
kanopi_depan	kanopi	depan	1
karena_depan	karena	depan	1
karena_didepan	karena	didepan	1
karena_mengedepankan	karena	mengedepankan	1
kata_depan	kata	depan	1
ke_depankan	ke	depankan	1
ke_depanlah	ke	depanlah	1
ke_depanya	ke	depanya	1
ke-depan_ancam	ke-depan	ancam	1
ke-depan_ci-tra	ke-depan	ci-tra	1
ke-depan_di	ke-depan	di	1
ke-depan_jumlah	ke-depan	jumlah	1
ke-depan_melalui	ke-depan	melalui	1
ke-depan_patut	ke-depan	patut	1
ke-depan_sebab	ke-depan	sebab	1
ke-depan_telah	ke-depan	telah	1
ke-depankan_etika	ke-depankan	etika	1
ke-depannya_ungkap	ke-depannya	ungkap	1
kebaikan_kedepan	kebaikan	kedepan	1
kebangsaan_kedepan	kebangsaan	kedepan	1
keberlanjutan_kedepannya	keberlanjutan	kedepannya	1
kedepan_agenda	kedepan	agenda	1
kedepan_ajang	kedepan	ajang	1
kedepan_aka	kedepan	aka	1
kedepan_anak-anak	kedepan	anak-anak	1
kedepan_anggota	kedepan	anggota	1
kedepan_apalagi	kedepan	apalagi	1
kedepan_apam	kedepan	apam	1
kedepan_aparat	kedepan	aparat	1
kedepan_arena	kedepan	arena	1
kedepan_atau	kedepan	atau	1
kedepan_bagaimana	kedepan	bagaimana	1
kedepan_bantuannya	kedepan	bantuannya	1
kedepan_banyak	kedepan	banyak	1
kedepan_benar-benar	kedepan	benar-benar	1
kedepan_bergerak	kedepan	bergerak	1
kedepan_cabang	kedepan	cabang	1
kedepan_cedera	kedepan	cedera	1
kedepan_dari	kedepan	dari	1
kedepan_data-data	kedepan	data-data	1
kedepan_dia	kedepan	dia	1
kedepan_didorong	kedepan	didorong	1
kedepan_diekspektasikan	kedepan	diekspektasikan	1
kedepan_diharapkan	kedepan	diharapkan	1
kedepan_dimana	kedepan	dimana	1
kedepan_dipastikan	kedepan	dipastikan	1
kedepan_diperkirakan	kedepan	diperkirakan	1
kedepan_faktor	kedepan	faktor	1
kedepan_hal-hal	kedepan	hal-hal	1
kedepan_ilmu	kedepan	ilmu	1
kedepan_industri	kedepan	industri	1
kedepan_jadi	kedepan	jadi	1
kedepan_jalan	kedepan	jalan	1
kedepan_jauh	kedepan	jauh	1
kedepan_jelasnya	kedepan	jelasnya	1
kedepan_jika	kedepan	jika	1
kedepan_kalangan	kedepan	kalangan	1
kedepan_kan	kedepan	kan	1
kedepan_karir	kedepan	karir	1
kedepan_kata-nya	kedepan	kata-nya	1
kedepan_keadaan	kedepan	keadaan	1
kedepan_kedepan	kedepan	kedepan	1
kedepan_kemana	kedepan	kemana	1
kedepan_kemu-dian	kedepan	kemu-dian	1
kedepan_kemungkinan	kedepan	kemungkinan	1
kedepan_kereta	kedepan	kereta	1
kedepan_ketersediaan	kedepan	ketersediaan	1
kedepan_ketus	kedepan	ketus	1
kedepan_kinerja	kedepan	kinerja	1
kedepan_kita	kedepan	kita	1
kedepan_kota	kedepan	kota	1
kedepan_lanjut	kedepan	lanjut	1
kedepan_lebih	kedepan	lebih	1
kedepan_mampu	kedepan	mampu	1
kedepan_mencegah	kedepan	mencegah	1
kedepan_menjadi	kedepan	menjadi	1
kedepan_menurut	kedepan	menurut	1
kedepan_mereka	kedepan	mereka	1
kedepan_meski	kedepan	meski	1
kedepan_metode	kedepan	metode	1
kedepan_minapolitan	kedepan	minapolitan	1
kedepan_paling	kedepan	paling	1
kedepan_pastilah	kedepan	pastilah	1
kedepan_pelaksa-naan	kedepan	pelaksa-naan	1
kedepan_pelaku	kedepan	pelaku	1
kedepan_pembangunannya	kedepan	pembangunannya	1
kedepan_pengurus	kedepan	pengurus	1
kedepan_peradaban	kedepan	peradaban	1
kedepan_perguruan	kedepan	perguruan	1
kedepan_perwira-perwira	kedepan	perwira-perwira	1
kedepan_pesantren	kedepan	pesantren	1
kedepan_pihaknya	kedepan	pihaknya	1
kedepan_pinta	kedepan	pinta	1
kedepan_prilaku	kedepan	prilaku	1
kedepan_problem	kedepan	problem	1
kedepan_produk	kedepan	produk	1
kedepan_profesi	kedepan	profesi	1
kedepan_puluhan	kedepan	puluhan	1
kedepan_putusan	kedepan	putusan	1
kedepan_remaja	kedepan	remaja	1
kedepan_rencananya	kedepan	rencananya	1
kedepan_sambungnya	kedepan	sambungnya	1
kedepan_sebuah	kedepan	sebuah	1
kedepan_sebutnya	kedepan	sebutnya	1
kedepan_sejak	kedepan	sejak	1
kedepan_sekiranya	kedepan	sekiranya	1
kedepan_seluruh	kedepan	seluruh	1
kedepan_seperti	kedepan	seperti	1
kedepan_setelah	kedepan	setelah	1
kedepan_setiap	kedepan	setiap	1
kedepan_situasi	kedepan	situasi	1
kedepan_sosialisasi	kedepan	sosialisasi	1
kedepan_sosok	kedepan	sosok	1
kedepan_stok	kedepan	stok	1
kedepan_tambahnya	kedepan	tambahnya	1
kedepan_tandasnya	kedepan	tandasnya	1
kedepan_tapi	kedepan	tapi	1
kedepan_tegas	kedepan	tegas	1
kedepan_tender	kedepan	tender	1
kedepan_tepatnya	kedepan	tepatnya	1
kedepan_terbaikan	kedepan	terbaikan	1
kedepan_terhitung	kedepan	terhitung	1
kedepan_timpalnya	kedepan	timpalnya	1
kedepan_tukas	kedepan	tukas	1
kedepan_ujan	kedepan	ujan	1
kedepan_umpan	kedepan	umpan	1
kedepan_ungkap	kedepan	ungkap	1
kedepan_ungkapnya	kedepan	ungkapnya	1
kedepan_urai	kedepan	urai	1
kedepan_vaksi	kedepan	vaksi	1
kedepan_wanita	kedepan	wanita	1
kedepan_wilayah	kedepan	wilayah	1
kedepan_wisata	kedepan	wisata	1
kedepan_yaitu	kedepan	yaitu	1
kedepan-nya_pemerintah	kedepan-nya	pemerintah	1
kedepankan_bisnis	kedepankan	bisnis	1
kedepankan_dialog	kedepankan	dialog	1
kedepankan_faktor	kedepankan	faktor	1
kedepankan_juga	kedepankan	juga	1
kedepankan_kata	kedepankan	kata	1
kedepankan_kekuatan	kedepankan	kekuatan	1
kedepankan_kepentingan	kedepankan	kepentingan	1
kedepankan_khususnya	kedepankan	khususnya	1
kedepankan_konsep	kedepankan	konsep	1
kedepankan_nanti	kedepankan	nanti	1
kedepankan_perundingan	kedepankan	perundingan	1
kedepankan_profesionalisme	kedepankan	profesionalisme	1
kedepankan_segi	kedepankan	segi	1
kedepankan_toleransi	kedepankan	toleransi	1
kedepankan_tugas	kedepankan	tugas	1
kedepankan_tukasnya	kedepankan	tukasnya	1
kedepankan_ungkapnya	kedepankan	ungkapnya	1
kedepankan_unsur	kedepankan	unsur	1
kedepannya_aksi	kedepannya	aksi	1
kedepannya_apa	kedepannya	apa	1
kedepannya_bagaimana	kedepannya	bagaimana	1
kedepannya_bakal	kedepannya	bakal	1
kedepannya_berharap	kedepannya	berharap	1
kedepannya_bersama	kedepannya	bersama	1
kedepannya_bulu	kedepannya	bulu	1
kedepannya_diharapkan	kedepannya	diharapkan	1
kedepannya_diselesaikan	kedepannya	diselesaikan	1
kedepannya_harus	kedepannya	harus	1
kedepannya_intensitas	kedepannya	intensitas	1
kedepannya_itu	kedepannya	itu	1
kedepannya_juga	kedepannya	juga	1
kedepannya_jumlah	kedepannya	jumlah	1
kedepannya_lanjutnya	kedepannya	lanjutnya	1
kedepannya_mahasiswa	kedepannya	mahasiswa	1
kedepannya_market	kedepannya	market	1
kedepannya_masih	kedepannya	masih	1
kedepannya_masyarakat	kedepannya	masyarakat	1
kedepannya_melahirkan	kedepannya	melahirkan	1
kedepannya_membangun	kedepannya	membangun	1
kedepannya_memiliki	kedepannya	memiliki	1
kedepannya_menata	kedepannya	menata	1
kedepannya_mewujudkan	kedepannya	mewujudkan	1
kedepannya_paguyuban	kedepannya	paguyuban	1
kedepannya_patroli	kedepannya	patroli	1
kedepannya_perhatian	kedepannya	perhatian	1
kedepannya_proses	kedepannya	proses	1
kedepannya_revisi	kedepannya	revisi	1
kedepannya_semua	kedepannya	semua	1
kedepannya_seperti	kedepannya	seperti	1
kedepannya_setiap	kedepannya	setiap	1
kedepannya_siapapun	kedepannya	siapapun	1
kedepannya_siswa-siswa	kedepannya	siswa-siswa	1
kedepannya_tak	kedepannya	tak	1
kedepannya_terangnya	kedepannya	terangnya	1
kedepannya_tinggal	kedepannya	tinggal	1
kedepannya_ujar	kedepannya	ujar	1
kedepannya_untuk	kedepannya	untuk	1
kedepannya_warga	kedepannya	warga	1
kedepannya_yaitu	kedepannya	yaitu	1
kekdepan_diharapkan	kekdepan	diharapkan	1
keluarga_kedepan	keluarga	kedepan	1
kemajuan_kedepan	kemajuan	kedepan	1
kemungkinan_kedepan	kemungkinan	kedepan	1
keributan_depan	keributan	depan	1
keributan_didepan	keributan	didepan	1
kertas_terdepan	kertas	terdepan	1
keselokan_depan	keselokan	depan	1
kesuksesan_kedepan	kesuksesan	kedepan	1
ketoprak_kedepannya	ketoprak	kedepannya	1
keurutan_terdepan	keurutan	terdepan	1
khawatir_kedepannya	khawatir	kedepannya	1
kini_mengedepan	kini	mengedepan	1
kini_meÂ­ngeÂ­depankan	kini	meÂ­ngeÂ­depankan	1
kita_kedepannya	kita	kedepannya	1
kita_me-ngedepankan	kita	me-ngedepankan	1
kompetisi_kedepan	kompetisi	kedepan	1
kon-disi_depan	kon-disi	depan	1
kondisi_kedepannya	kondisi	kedepannya	1
korban_didepan	korban	didepan	1
kota_depan	kota	depan	1
kota_ter-depan	kota	ter-depan	1
kota_terdepan	kota	terdepan	1
kritik_didepan	kritik	didepan	1
kusta_kedepannya	kusta	kedepannya	1
laga_kedepan	laga	kedepan	1
lagi_kedepan	lagi	kedepan	1
lagunya_mengedepankan	lagunya	mengedepankan	1
lain_depan	lain	depan	1
lalu_didepan	lalu	didepan	1
laman_depannya	laman	depannya	1
lampu_depannya	lampu	depannya	1
langkah_terdepan	langkah	terdepan	1
lantai_depan	lantai	depan	1
lapang_depan	lapang	depan	1
lapisan_depan	lapisan	depan	1
latihan_kedepan	latihan	kedepan	1
laut_kedepannya	laut	kedepannya	1
layar_depan	layar	depan	1
lebar_depan	lebar	depan	1
lebih_kedepankan	lebih	kedepankan	1
lebih_me-ngedepankan	lebih	me-ngedepankan	1
lebih_menge-depankan	lebih	menge-depankan	1
lebih_mengendepankan	lebih	mengendepankan	1
legislatif_kedepan	legislatif	kedepan	1
lembaga_indepanden	lembaga	indepanden	1
lestarikan_kedepannya	lestarikan	kedepannya	1
lewat_depan	lewat	depan	1
liburan_depan	liburan	depan	1
lihat_kedepannya	lihat	kedepannya	1
lini_depanlah	lini	depanlah	1
lini_ter-depan	lini	ter-depan	1
lintas_depan	lintas	depan	1
lobi_depan	lobi	depan	1
lokomotif_terdepan	lokomotif	terdepan	1
lupa_dikedepankan	lupa	dikedepankan	1
maju_kedepannya	maju	kedepannya	1
maka_kedepannya	maka	kedepannya	1
makin_mengedepankan	makin	mengedepankan	1
maksimal_kedepan	maksimal	kedepan	1
malah_menge-depankan	malah	menge-depankan	1
mangga_depan	mangga	depan	1
mari_ke-depankan	mari	ke-depankan	1
masa_depan-nya	masa	depan-nya	1
masa-masa_ke-depan	masa-masa	ke-depan	1
masadepan_kondisi	masadepan	kondisi	1
masalah_depan	masalah	depan	1
masyarakat_kedepan	masyarakat	kedepan	1
masyarakat_kedepannya	masyarakat	kedepannya	1
masyarakat_terdepan	masyarakat	terdepan	1
mata_didepan	mata	didepan	1
mau_depan	mau	depan	1
mau-pun_kedepan	mau-pun	kedepan	1
me-menuhi_depan	me-menuhi	depan	1
me-ngedepankan_aspek	me-ngedepankan	aspek	1
me-ngedepankan_bobot	me-ngedepankan	bobot	1
me-ngedepankan_efisiensi	me-ngedepankan	efisiensi	1
me-ngedepankan_independensi	me-ngedepankan	independensi	1
me-ngedepankan_interaktif	me-ngedepankan	interaktif	1
me-ngedepankan_kebutuhan	me-ngedepankan	kebutuhan	1
me-ngedepankan_kepentingan	me-ngedepankan	kepentingan	1
me-ngedepankan_kesederhanaan	me-ngedepankan	kesederhanaan	1
me-ngedepankan_konsep	me-ngedepankan	konsep	1
me-ngedepankan_mekanisme	me-ngedepankan	mekanisme	1
me-ngedepankan_pembuktian	me-ngedepankan	pembuktian	1
me-ngedepankan_pengusaha	me-ngedepankan	pengusaha	1
me-ngedepankan_proses	me-ngedepankan	proses	1
me-ngedepankan_puji-pujian	me-ngedepankan	puji-pujian	1
me-ngedepankan_rumusan	me-ngedepankan	rumusan	1
me-ngedepankan_stabilitas	me-ngedepankan	stabilitas	1
me-ngedepankan_upaya-upaya	me-ngedepankan	upaya-upaya	1
me-nunggu_depan	me-nunggu	depan	1
megedepankan_rasa	megedepankan	rasa	1
melainkan_mengedepankan	melainkan	mengedepankan	1
melintas_didepannya	melintas	didepannya	1
melulu_mengedepankan	melulu	mengedepankan	1
memadati_depan	memadati	depan	1
memanfaatkan_depan	memanfaatkan	depan	1
memang_mengedepankan	memang	mengedepankan	1
membawa_didepan	membawa	didepan	1
memenuhi_depan	memenuhi	depan	1
memilih_depan	memilih	depan	1
meminta_kedepannya	meminta	kedepannya	1
menambahkan_kedepannya	menambahkan	kedepannya	1
mencemari_depan	mencemari	depan	1
mengadang_didepan	mengadang	didepan	1
mengatakan_kedepannya	mengatakan	kedepannya	1
menge_depankan	menge	depankan	1
menge-depan_di	menge-depan	di	1
menge-depankan_aturan	menge-depankan	aturan	1
menge-depankan_bimbingan	menge-depankan	bimbingan	1
menge-depankan_dialektika	menge-depankan	dialektika	1
menge-depankan_disiplin	menge-depankan	disiplin	1
menge-depankan_ekonomi	menge-depankan	ekonomi	1
menge-depankan_kedekatan	menge-depankan	kedekatan	1
menge-depankan_kenyamanan	menge-depankan	kenyamanan	1
menge-depankan_musyawarah	menge-depankan	musyawarah	1
menge-depankan_permodalan	menge-depankan	permodalan	1
menge-depankan_pola	menge-depankan	pola	1
menge-depankan_politik	menge-depankan	politik	1
menge-depankan_program	menge-depankan	program	1
menge-depankan_proses	menge-depankan	proses	1
menge-depankan_sektor	menge-depankan	sektor	1
mengedepan_beranekaragam	mengedepan	beranekaragam	1
mengedepan_berikut	mengedepan	berikut	1
mengedepan_menjadi	mengedepan	menjadi	1
mengedepan_saat	mengedepan	saat	1
mengedepan_sebagai	mengedepan	sebagai	1
mengedepan_sebetulnya	mengedepan	sebetulnya	1
mengedepan_tentu	mengedepan	tentu	1
mengedepan-kan_asas	mengedepan-kan	asas	1
mengedepan-kan_falsafah	mengedepan-kan	falsafah	1
mengedepan-kan_kepentingan	mengedepan-kan	kepentingan	1
mengedepan-kan_koordinasi	mengedepan-kan	koordinasi	1
mengedepan-kan_motivasi	mengedepan-kan	motivasi	1
mengedepan-kan_motto	mengedepan-kan	motto	1
mengedepan-kan_pelayan	mengedepan-kan	pelayan	1
mengedepan-kan_pelayanan	mengedepan-kan	pelayanan	1
mengedepan-kan_pembangunan	mengedepan-kan	pembangunan	1
mengedepan-kan_pengembangan	mengedepan-kan	pengembangan	1
mengedepan-kan_rasa	mengedepan-kan	rasa	1
mengedepan-kan_three	mengedepan-kan	three	1
mengedepan-kan_visi	mengedepan-kan	visi	1
mengedepanjan_strategi	mengedepanjan	strategi	1
mengedepankan_adu	mengedepankan	adu	1
mengedepankan_akuntabilitas	mengedepankan	akuntabilitas	1
mengedepankan_amar	mengedepankan	amar	1
mengedepankan_analisa	mengedepankan	analisa	1
mengedepankan_aplikasi	mengedepankan	aplikasi	1
mengedepankan_aspek-aspek	mengedepankan	aspek-aspek	1
mengedepankan_bagaimana	mengedepankan	bagaimana	1
mengedepankan_bangunan	mengedepankan	bangunan	1
mengedepankan_banyaknya	mengedepankan	banyaknya	1
mengedepankan_berbelanja	mengedepankan	berbelanja	1
mengedepankan_bottom	mengedepankan	bottom	1
mengedepankan_calon	mengedepankan	calon	1
mengedepankan_campaign	mengedepankan	campaign	1
mengedepankan_cinta	mengedepankan	cinta	1
mengedepankan_daya	mengedepankan	daya	1
mengedepankan_demonstrasi	mengedepankan	demonstrasi	1
mengedepankan_desain-desain	mengedepankan	desain-desain	1
mengedepankan_deteksi	mengedepankan	deteksi	1
mengedepankan_digital	mengedepankan	digital	1
meÂ­ngedepankan_diplomasi	meÂ­ngedepankan	diplomasi	1
mengedepankan_disiplin	mengedepankan	disiplin	1
mengedepankan_edukasi	mengedepankan	edukasi	1
mengedepankan_ego	mengedepankan	ego	1
mengedepankan_egoisme	mengedepankan	egoisme	1
mengedepankan_egonya	mengedepankan	egonya	1
mengedepankan_ekonomi	mengedepankan	ekonomi	1
mengedepankan_elemen	mengedepankan	elemen	1
mengedepankan_emosi	mengedepankan	emosi	1
mengedepankan_empati	mengedepankan	empati	1
mengedepankan_figur	mengedepankan	figur	1
mengedepankan_filosofi	mengedepankan	filosofi	1
mengedepankan_filsafat	mengedepankan	filsafat	1
mengedepankan_fleksibilitas	mengedepankan	fleksibilitas	1
mengedepankan_formalitas	mengedepankan	formalitas	1
mengedepankan_fungsi-fungsi	mengedepankan	fungsi-fungsi	1
mengedepankan_hak	mengedepankan	hak	1
mengedepankan_harga	mengedepankan	harga	1
mengedepankan_harmoni	mengedepankan	harmoni	1
mengedepankan_higienitas	mengedepankan	higienitas	1
mengedepankan_hu-kum	mengedepankan	hu-kum	1
mengedepankan_ilmu	mengedepankan	ilmu	1
mengedepankan_in-dependennya	mengedepankan	in-dependennya	1
mengedepankan_industri	mengedepankan	industri	1
mengedepankan_ini	mengedepankan	ini	1
mengedepankan_insight	mengedepankan	insight	1
mengedepankan_instru-mental	mengedepankan	instru-mental	1
mengedepankan_investasi	mengedepankan	investasi	1
mengedepankan_istiqomah	mengedepankan	istiqomah	1
mengedepankan_jalur	mengedepankan	jalur	1
mengedepankan_jaringan	mengedepankan	jaringan	1
mengedepankan_jasa	mengedepankan	jasa	1
mengedepankan_juga	mengedepankan	juga	1
mengedepankan_kapal	mengedepankan	kapal	1
mengedepankan_karir	mengedepankan	karir	1
mengedepankan_ke-inginan	mengedepankan	ke-inginan	1
mengedepankan_ke-pentingan	mengedepankan	ke-pentingan	1
mengedepankan_keadaban	mengedepankan	keadaban	1
mengedepankan_keadilan	mengedepankan	keadilan	1
mengedepankan_kebersa-maan	mengedepankan	kebersa-maan	1
mengedepankan_kebersamaan	mengedepankan	kebersamaan	1
mengedepankan_kebijakan	mengedepankan	kebijakan	1
mengedepankan_kebudayaan	mengedepankan	kebudayaan	1
mengedepankan_keesaan	mengedepankan	keesaan	1
mengedepankan_kehati-hatian	mengedepankan	kehati-hatian	1
mengedepankan_kehendak	mengedepankan	kehendak	1
mengedepankan_kehendaknya	mengedepankan	kehendaknya	1
mengedepankan_kekayaan	mengedepankan	kekayaan	1
mengedepankan_kekeluargaan	mengedepankan	kekeluargaan	1
mengedepankan_kekerasan	mengedepankan	kekerasan	1
mengedepankan_kemanusiaan	mengedepankan	kemanusiaan	1
mengedepankan_kemur-nian	mengedepankan	kemur-nian	1
mengedepankan_kenyamanan	mengedepankan	kenyamanan	1
mengedepankan_kepenting-an	mengedepankan	kepenting-an	1
mengedepankan_keputusan	mengedepankan	keputusan	1
mengedepankan_kesadaran	mengedepankan	kesadaran	1
mengedepankan_kesak-sian	mengedepankan	kesak-sian	1
mengedepankan_kesejahteraan	mengedepankan	kesejahteraan	1
mengedepankan_keselamatan	mengedepankan	keselamatan	1
mengedepankan_ketepa-tan	mengedepankan	ketepa-tan	1
mengedepankan_keterbukaan	mengedepankan	keterbukaan	1
mengedepankan_ketidakberpihakan	mengedepankan	ketidakberpihakan	1
mengedepankan_ketrampilan	mengedepankan	ketrampilan	1
mengedepankan_keutuhan	mengedepankan	keutuhan	1
mengedepankan_kewaspadaan	mengedepankan	kewaspadaan	1
mengedepankan_ki-nerja	mengedepankan	ki-nerja	1
mengedepankan_kolaborasi	mengedepankan	kolaborasi	1
mengedepankan_kompetensi	mengedepankan	kompetensi	1
mengedepankan_kredibilitas	mengedepankan	kredibilitas	1
mengedepankan_kua-litas	mengedepankan	kua-litas	1
mengedepankan_kuali-tas	mengedepankan	kuali-tas	1
mengedepankan_la-yanan	mengedepankan	la-yanan	1
mengedepankan_langkah-langkah	mengedepankan	langkah-langkah	1
mengedepankan_local	mengedepankan	local	1
mengedepankan_logika	mengedepankan	logika	1
mengedepankan_lokal	mengedepankan	lokal	1
mengedepankan_lokalitas	mengedepankan	lokalitas	1
mengedepankan_materi	mengedepankan	materi	1
mengedepankan_me-kanisme	mengedepankan	me-kanisme	1
mengedepankan_mekanisme	mengedepankan	mekanisme	1
mengedepankan_menu	mengedepankan	menu	1
mengedepankan_militansi	mengedepankan	militansi	1
mengedepankan_moderasi	mengedepankan	moderasi	1
mengedepankan_morali-tas	mengedepankan	morali-tas	1
mengedepankan_moralitas	mengedepankan	moralitas	1
mengedepankan_muatan	mengedepankan	muatan	1
mengedepankan_musyawarah	mengedepankan	musyawarah	1
mengedepankan_nama	mengedepankan	nama	1
mengedepankan_negosiasi	mengedepankan	negosiasi	1
mengedepankan_norma	mengedepankan	norma	1
mengedepankan_objektivitas	mengedepankan	objektivitas	1
mengedepankan_pakta	mengedepankan	pakta	1
mengedepankan_pariwisata	mengedepankan	pariwisata	1
mengedepankan_partisipasi	mengedepankan	partisipasi	1
mengedepankan_pe-rasaan	mengedepankan	pe-rasaan	1
mengedepankan_pela-yanan	mengedepankan	pela-yanan	1
mengedepankan_pelajaran-pelajaran	mengedepankan	pelajaran-pelajaran	1
mengedepankan_pelestarian	mengedepankan	pelestarian	1
mengedepankan_pembuktian	mengedepankan	pembuktian	1
mengedepankan_peme-rataan	mengedepankan	peme-rataan	1
mengedepankan_pencegahan	mengedepankan	pencegahan	1
mengedepankan_pendapat	mengedepankan	pendapat	1
mengedepankan_pendidikan	mengedepankan	pendidikan	1
mengedepankan_peng-hematan	mengedepankan	peng-hematan	1
mengedepankan_pengabdian	mengedepankan	pengabdian	1
mengedepankan_pengamanan	mengedepankan	pengamanan	1
mengedepankan_pengenalan	mengedepankan	pengenalan	1
mengedepankan_penguasaan	mengedepankan	penguasaan	1
mengedepankan_penyampaian	mengedepankan	penyampaian	1
mengedepankan_penyelesaian	mengedepankan	penyelesaian	1
mengedepankan_perbedaan-perbedaan	mengedepankan	perbedaan-perbedaan	1
mengedepankan_perdamaian	mengedepankan	perdamaian	1
mengedepankan_perekrutan	mengedepankan	perekrutan	1
mengedepankan_perencanaan	mengedepankan	perencanaan	1
mengedepankan_perilaku	mengedepankan	perilaku	1
mengedepankan_perlindungan	mengedepankan	perlindungan	1
mengedepankan_persau-daraan	mengedepankan	persau-daraan	1
mengedepankan_perusahaan	mengedepankan	perusahaan	1
mengedepankan_pesan-pesan	mengedepankan	pesan-pesan	1
mengedepankan_pintu	mengedepankan	pintu	1
mengedepankan_pola	mengedepankan	pola	1
mengedepankan_potensi	mengedepankan	potensi	1
mengedepankan_praduga	mengedepankan	praduga	1
mengedepankan_precautionary	mengedepankan	precautionary	1
mengedepankan_prejudice	mengedepankan	prejudice	1
mengedepankan_pro-gram	mengedepankan	pro-gram	1
mengedepankan_profesiona-lisme	mengedepankan	profesiona-lisme	1
mengedepankan_profesionalis-me	mengedepankan	profesionalis-me	1
mengedepankan_profesionalisme	mengedepankan	profesionalisme	1
mengedepankan_profesionalitas	mengedepankan	profesionalitas	1
mengedepankan_promosi	mengedepankan	promosi	1
mengedepankan_publikasi	mengedepankan	publikasi	1
mengedepankan_rahmah	mengedepankan	rahmah	1
mengedepankan_rakyat	mengedepankan	rakyat	1
mengedepankan_rambu-rambu	mengedepankan	rambu-rambu	1
mengedepankan_rasionalisme	mengedepankan	rasionalisme	1
mengedepankan_sasarannya	mengedepankan	sasarannya	1
mengedepankan_segi	mengedepankan	segi	1
mengedepankan_semua	mengedepankan	semua	1
mengedepankan_seni	mengedepankan	seni	1
mengedepankan_sensasi	mengedepankan	sensasi	1
mengedepankan_sepak	mengedepankan	sepak	1
mengedepankan_seperti	mengedepankan	seperti	1
mengedepankan_sifat	mengedepankan	sifat	1
mengedepankan_silaturahmi	mengedepankan	silaturahmi	1
mengedepankan_sinergitas	mengedepankan	sinergitas	1
mengedepankan_soal	mengedepankan	soal	1
mengedepankan_soft	mengedepankan	soft	1
mengedepankan_sosok	mengedepankan	sosok	1
mengedepankan_spirit	mengedepankan	spirit	1
mengedepankan_spotifitas	mengedepankan	spotifitas	1
mengedepankan_srategi	mengedepankan	srategi	1
mengedepankan_sukses	mengedepankan	sukses	1
mengedepankan_sum-pah	mengedepankan	sum-pah	1
mengedepankan_sumber	mengedepankan	sumber	1
mengedepankan_supremasi	mengedepankan	supremasi	1
mengedepankan_survei	mengedepankan	survei	1
mengedepankan_tema	mengedepankan	tema	1
mengedepankan_tenaga	mengedepankan	tenaga	1
mengedepankan_tentang	mengedepankan	tentang	1
mengedepankan_terobosan	mengedepankan	terobosan	1
mengedepankan_tertib	mengedepankan	tertib	1
mengedepankan_tiga	mengedepankan	tiga	1
meÂ­ngeÂ­depankan_tiga	meÂ­ngeÂ­depankan	tiga	1
mengedepankan_tindakan	mengedepankan	tindakan	1
mengedepankan_trans-paransi	mengedepankan	trans-paransi	1
mengedepankan_transparan	mengedepankan	transparan	1
mengedepankan_tujuan	mengedepankan	tujuan	1
mengedepankan_udara	mengedepankan	udara	1
mengedepankan_untuk	mengedepankan	untuk	1
mengedepankan_upaya-upaya	mengedepankan	upaya-upaya	1
mengedepankan_urgensi	mengedepankan	urgensi	1
mengedepankan_wajah	mengedepankan	wajah	1
mengenai_masadepan	mengenai	masadepan	1
mengendepankan_keuntungan	mengendepankan	keuntungan	1
mengendepankan_pendekatan	mengendepankan	pendekatan	1
mengendepankan_unsurobjektifitas	mengendepankan	unsurobjektifitas	1
menghadap_depan	menghadap	depan	1
mengharapkan_kedepannya	mengharapkan	kedepannya	1
menjadiyang_terdepan	menjadiyang	terdepan	1
menuju_depan	menuju	depan	1
menyampaikan_kedepan	menyampaikan	kedepan	1
meramal_masadepan	meramal	masadepan	1
mesin_terdepan	mesin	terdepan	1
mesti_dikedepan-kan	mesti	dikedepan-kan	1
mesti_dikedepankan	mesti	dikedepankan	1
mesti_mengedepankan	mesti	mengedepankan	1
mestinya_mengedepankan	mestinya	mengedepankan	1
mi-nggu_depan	mi-nggu	depan	1
mikrolet_depan	mikrolet	depan	1
ming-gu_depan	ming-gu	depan	1
mingggu_depan	mingggu	depan	1
minggu-minggu_depan	minggu-minggu	depan	1
misinya_kedepan	misinya	kedepan	1
mobil_depan	mobil	depan	1
mobil_didepannya	mobil	didepannya	1
mogot_depan	mogot	depan	1
motor_depan	motor	depan	1
mu-sim_depan	mu-sim	depan	1
mufakat_mengedepankan	mufakat	mengedepankan	1
mulai_di-kedepankan	mulai	di-kedepankan	1
mulai_mengedepankan	mulai	mengedepankan	1
mungkin_kedepan	mungkin	kedepan	1
mungkin_mengedepankan	mungkin	mengedepankan	1
nafsu_mengedepankan	nafsu	mengedepankan	1
nanti_mengedepankan	nanti	mengedepankan	1
nikah_mengedepankan	nikah	mengedepankan	1
nonton_depan	nonton	depan	1
odong-odong_didepan	odong-odong	didepan	1
ojek_depan	ojek	depan	1
olahraga_terdepan	olahraga	terdepan	1
operator_mengedepankan	operator	mengedepankan	1
opti-mistis_kedepan	opti-mistis	kedepan	1
optimal_kedepannya	optimal	kedepannya	1
orang_terdepan	orang	terdepan	1
orang-orang_terdepan	orang-orang	terdepan	1
orasi_didepan	orasi	didepan	1
organisasi_terdepan	organisasi	terdepan	1
ornamen_depan	ornamen	depan	1
pada_depan	pada	depan	1
pagar_depan	pagar	depan	1
panas_depan	panas	depan	1
pandang_depan	pandang	depan	1
panel_depannya	panel	depannya	1
pangkalan_depan	pangkalan	depan	1
pantas_dikedepankan	pantas	dikedepankan	1
pariwisata_kedepan	pariwisata	kedepan	1
pariwisata_terdepan	pariwisata	terdepan	1
partai_kedepan	partai	kedepan	1
pas_depan	pas	depan	1
pasti_depan	pasti	depan	1
patut_dikedepan-kan	patut	dikedepan-kan	1
pe-main_kedepan	pe-main	kedepan	1
pecan_depan	pecan	depan	1
pekarangan_depan	pekarangan	depan	1
pelajaran_kedepannya	pelajaran	kedepannya	1
pelaksanannya_mengedepankan	pelaksanannya	mengedepankan	1
pelataran_depan	pelataran	depan	1
pemain_depannya	pemain	depannya	1
pemain_kedepan	pemain	kedepan	1
peman_depan	peman	depan	1
pembalap_didepannya	pembalap	didepannya	1
pembalap_ter-depan	pembalap	ter-depan	1
pembangunan_mengedepankan	pembangunan	mengedepankan	1
pembayaran_terdepan	pembayaran	terdepan	1
pembungkus_depan	pembungkus	depan	1
pembunuhan_dikedepankan	pembunuhan	dikedepankan	1
pemerintah_kedepan	pemerintah	kedepan	1
pemerintahan_kedepan	pemerintahan	kedepan	1
pemkot_mengedepankan	pemkot	mengedepankan	1
penampilannya_kedepan	penampilannya	kedepan	1
pencerahan_kedepan	pencerahan	kedepan	1
pendanaan_kedepannya	pendanaan	kedepannya	1
pendarat_depan	pendarat	depan	1
pendidikan_kedepannya	pendidikan	kedepannya	1
pendidikan_mengedepankan	pendidikan	mengedepankan	1
pendidikan_terdepan	pendidikan	terdepan	1
pendopo_depan	pendopo	depan	1
penerapannya_dikedepankan	penerapannya	dikedepankan	1
pengadilan_mengedepankan	pengadilan	mengedepankan	1
pengamanan_depan	pengamanan	depan	1
pengembagannya_kedepan	pengembagannya	kedepan	1
pengembangan_kedepan	pengembangan	kedepan	1
penggal_depan	penggal	depan	1
penggunaan_depan-belakang	penggunaan	depan-belakang	1
penghasilan_kedepan	penghasilan	kedepan	1
penumpang_depan	penumpang	depan	1
penumpang_kedepan	penumpang	kedepan	1
penutup_depannya	penutup	depannya	1
penyeberangan_depan	penyeberangan	depan	1
penyi-dikan_kedepan	penyi-dikan	kedepan	1
penyidikan_kedepan	penyidikan	kedepan	1
per_depan	per	depan	1
per-gola_depan	per-gola	depan	1
per-lu_dikedepankan	per-lu	dikedepankan	1
perbaikan_ke-depannya	perbaikan	ke-depannya	1
perbaikan_kedepannya	perbaikan	kedepannya	1
perbatasan_mengedepankan	perbatasan	mengedepankan	1
perkembangan_kedepan	perkembangan	kedepan	1
permainan_depan	permainan	depan	1
permebelan_kedepan	permebelan	kedepan	1
pernah_menge-depankan	pernah	menge-depankan	1
persaingan_kedepan	persaingan	kedepan	1
perubahan_kedepan	perubahan	kedepan	1
pesepakbola_kedepannya	pesepakbola	kedepannya	1
peserta_mengedepankan	peserta	mengedepankan	1
pihaknya_kedepan	pihaknya	kedepan	1
pihaknya_mengedepankan	pihaknya	mengedepankan	1
pintu_terdepan	pintu	terdepan	1
plat_depan	plat	depan	1
po-sisi_terdepan	po-sisi	terdepan	1
pohon_depan	pohon	depan	1
politik_kedepan	politik	kedepan	1
poros_terdepan	poros	terdepan	1
pos_depan	pos	depan	1
posisi_ter-depan	posisi	ter-depan	1
poskamling_depan	poskamling	depan	1
proaktif_mengedepankan	proaktif	mengedepankan	1
produk_ter-depan	produk	ter-depan	1
program-program_terdepan	program-program	terdepan	1
properti_terdepan	properti	terdepan	1
propinsi_terdepan	propinsi	terdepan	1
prospek_kedepan	prospek	kedepan	1
pujasera_depan	pujasera	depan	1
pulau_terdepanyang	pulau	terdepanyang	1
pun_dikedepankan	pun	dikedepankan	1
pun_kedepannya	pun	kedepannya	1
rajin_dikedepankan	rajin	dikedepankan	1
rak_depan	rak	depan	1
red_depan	red	depan	1
reformasi_mengedepankan	reformasi	mengedepankan	1
religi_didepan	religi	didepan	1
ringroad_depan	ringroad	depan	1
roda_depannya	roda	depannya	1
rombongan_depan	rombongan	depan	1
rotasi_didepan	rotasi	didepan	1
saat_kedepan	saat	kedepan	1
saja_kedepan	saja	kedepan	1
saja_kedepannya	saja	kedepannya	1
saluran_depan	saluran	depan	1
sama_kedepan	sama	kedepan	1
sama-sama_mengedepankan	sama-sama	mengedepankan	1
sambil_mengedepankan	sambil	mengedepankan	1
sampai_didepan	sampai	didepan	1
samping_depannya	samping	depannya	1
santer_dikedepankan	santer	dikedepankan	1
santun_mengedepankan	santun	mengedepankan	1
sapaannya_mengedepankan	sapaannya	mengedepankan	1
sapi_terdepan	sapi	terdepan	1
satai_depan	satai	depan	1
satu_depan	satu	depan	1
saya_kedepan	saya	kedepan	1
sayap_depan	sayap	depan	1
se-nantiasa_mengedepankan	se-nantiasa	mengedepankan	1
sebagai_depan	sebagai	depan	1
sebaiknya_mengedepankan	sebaiknya	mengedepankan	1
sebelah_depan	sebelah	depan	1
secara_indepanden	secara	indepanden	1
segera_dikedepankan	segera	dikedepankan	1
sejahtera_kedepannya	sejahtera	kedepannya	1
sekiranya_kedepan	sekiranya	kedepan	1
sekolah_kedepan	sekolah	kedepan	1
selain_mengedepankan	selain	mengedepankan	1
selalu_kedepankan	selalu	kedepankan	1
selalu_mengedepan-kan	selalu	mengedepan-kan	1
selasa_depan	selasa	depan	1
semakin_mengedepan	semakin	mengedepan	1
semakin_terdepan	semakin	terdepan	1
semangat_mengedepankan	semangat	mengedepankan	1
sementara_depan	sementara	depan	1
sementara_kedepan	sementara	kedepan	1
semester_depan	semester	depan	1
semestinya_dikedepankan	semestinya	dikedepankan	1
senantiasa_terdepan	senantiasa	terdepan	1
sendiri_mengedepankan	sendiri	mengedepankan	1
senin_depan	senin	depan	1
seolah-olah_mengedepan	seolah-olah	mengedepan	1
sepakat_mengedepankan	sepakat	mengedepankan	1
sepekan_kedepan	sepekan	kedepan	1
seperti_depan	seperti	depan	1
sering_dikedepankan	sering	dikedepankan	1
sering_mengedepankan	sering	mengedepankan	1
serta_depan	serta	depan	1
serupa_kedepannya	serupa	kedepannya	1
setiap_depan	setiap	depan	1
seyogianya_dikedepankan	seyogianya	dikedepankan	1
seyogianya_mengedepankan	seyogianya	mengedepankan	1
siang_didepan	siang	didepan	1
sikap_kedepan	sikap	kedepan	1
sikap_mengedepankan	sikap	mengedepankan	1
sini_depan	sini	depan	1
sini_kedepannya	sini	kedepannya	1
sisa_kedepan	sisa	kedepan	1
siswa_mengedepankan	siswa	mengedepankan	1
smoga_kedepan	smoga	kedepan	1
solusi_kedepannya	solusi	kedepannya	1
spakbor_depan	spakbor	depan	1
spatbor_depan	spatbor	depan	1
staf_terdepan	staf	terdepan	1
strategi_kedepan	strategi	kedepan	1
strategi_kedepannya	strategi	kedepannya	1
strategi_terdepan	strategi	terdepan	1
sukseskan_kedepan	sukseskan	kedepan	1
sungguh-sungguh_dike-depankan	sungguh-sungguh	dike-depankan	1
supaya_kedepan	supaya	kedepan	1
suporter_mengedepankan	suporter	mengedepankan	1
swasta_terdepan	swasta	terdepan	1
ta-hun_kedepan	ta-hun	kedepan	1
tabrakan_depan	tabrakan	depan	1
tahu_depan	tahu	depan	1
tahun_depannya	tahun	depannya	1
tahun_depanSabtu	tahun	depanSabtu	1
tahun-tahun_kedepan	tahun-tahun	kedepan	1
tak_mengedepankan	tak	mengedepankan	1
tam-pil_terdepan	tam-pil	terdepan	1
tambahan_kedepannya	tambahan	kedepannya	1
tampang_depan	tampang	depan	1
tangga_depan	tangga	depan	1
tantangan_kedepan	tantangan	kedepan	1
tantangan_kedepannya	tantangan	kedepannya	1
tantangan_terdepan	tantangan	terdepan	1
tapi_depan	tapi	depan	1
tari_kedepan	tari	kedepan	1
tau_kedepannya	tau	kedepannya	1
te-tap_mengedepankan	te-tap	mengedepankan	1
teknologi_kedepannya	teknologi	kedepannya	1
telekomunikasi_terdepan	telekomunikasi	terdepan	1
tempat_terdepan	tempat	terdepan	1
tengah_depan	tengah	depan	1
tentang_mengedepankan	tentang	mengedepankan	1
tentu_mengedepankan	tentu	mengedepankan	1
tentunya_me-ngedepankan	tentunya	me-ngedepankan	1
tepat_didepannya	tepat	didepannya	1
tepatnya_di-depan	tepatnya	di-depan	1
tepatnya_didepan	tepatnya	didepan	1
ter-depan_bersama	ter-depan	bersama	1
ter-depan_da-lam	ter-depan	da-lam	1
ter-depan_dan	ter-depan	dan	1
ter-depan_dengan	ter-depan	dengan	1
ter-depan_saling	ter-depan	saling	1
ter-depan_tandasnya	ter-depan	tandasnya	1
ter-depan_tidak	ter-depan	tidak	1
ter-depan_untuk	ter-depan	untuk	1
terapresiasi_kedepannya	terapresiasi	kedepannya	1
terbarukan_kedepan	terbarukan	kedepan	1
terbesar_kedepannya	terbesar	kedepannya	1
terdepan_adalah	terdepan	adalah	1
terdepan_apabila	terdepan	apabila	1
terdepan_atau	terdepan	atau	1
terdepan_bahasan	terdepan	bahasan	1
terdepan_bahkan	terdepan	bahkan	1
terdepan_bangsa	terdepan	bangsa	1
terdepan_bergerak	terdepan	bergerak	1
terdepan_bisa	terdepan	bisa	1
terdepan_budi	terdepan	budi	1
terdepan_daerah-daerah	terdepan	daerah-daerah	1
terdepan_demi	terdepan	demi	1
terdepan_diantara	terdepan	diantara	1
terdepan_diberikan	terdepan	diberikan	1
terdepan_didalam	terdepan	didalam	1
terdepan_ekonomi	terdepan	ekonomi	1
terdepan_enam	terdepan	enam	1
terdepan_film-film	terdepan	film-film	1
terdepan_ha-rus	terdepan	ha-rus	1
terdepan_hanpir	terdepan	hanpir	1
terdepan_ini	terdepan	ini	1
terdepan_jika	terdepan	jika	1
terdepan_kampanye	terdepan	kampanye	1
terdepan_karena	terdepan	karena	1
terdepan_kehidupan	terdepan	kehidupan	1
terdepan_kehilangan	terdepan	kehilangan	1
terdepan_khususnya	terdepan	khususnya	1
terdepan_lagi	terdepan	lagi	1
terdepan_lagiSabtu	terdepan	lagiSabtu	1
terdepan_langsung	terdepan	langsung	1
terdepan_lomba	terdepan	lomba	1
terdepan_masih	terdepan	masih	1
terdepan_memberantas	terdepan	memberantas	1
terdepan_membuat	terdepan	membuat	1
terdepan_memenangkan	terdepan	memenangkan	1
terdepan_mempromosikan	terdepan	mempromosikan	1
terdepan_menantang	terdepan	menantang	1
terdepan_mengambil	terdepan	mengambil	1
terdepan_mengawal	terdepan	mengawal	1
terdepan_menghargai	terdepan	menghargai	1
terdepan_mengungguli	terdepan	mengungguli	1
terdepan_menjaga	terdepan	menjaga	1
terdepan_menyadarkan	terdepan	menyadarkan	1
terdepan_mereka	terdepan	mereka	1
terdepan_merupakan	terdepan	merupakan	1
terdepan_nanti	terdepan	nanti	1
terdepan_pelayanan	terdepan	pelayanan	1
terdepan_pembangunan	terdepan	pembangunan	1
terdepan_peperangan	terdepan	peperangan	1
terdepan_peradapan	terdepan	peradapan	1
terdepan_pertahanan	terdepan	pertahanan	1
terdepan_sangat	terdepan	sangat	1
terdepan_seandainya	terdepan	seandainya	1
terdepan_sebab	terdepan	sebab	1
terdepan_sejak	terdepan	sejak	1
terdepan_selalu	terdepan	selalu	1
terdepan_setiap	terdepan	setiap	1
terdepan_tak	terdepan	tak	1
terdepan_tandasnya	terdepan	tandasnya	1
terdepan_terlihat	terdepan	terlihat	1
terdepan_tertinggal	terdepan	tertinggal	1
terdepan_terus	terdepan	terus	1
terdepan_tetap	terdepan	tetap	1
terdepan_tidak	terdepan	tidak	1
terdepan_twee	terdepan	twee	1
terdepan_ujar	terdepan	ujar	1
terdepan_un-tuk	terdepan	un-tuk	1
terdepan_usai	terdepan	usai	1
terdepannya_ada	terdepannya	ada	1
terdepanyang_sedang	terdepanyang	sedang	1
terjadi_kedepan	terjadi	kedepan	1
terlihat_engedepankan	terlihat	engedepankan	1
termasuk_depan	termasuk	depan	1
tersebut_dikedepankan	tersebut	dikedepankan	1
tersebut_kedepan	tersebut	kedepan	1
tersebut_kedepannya	tersebut	kedepannya	1
tersebut_mengedepan	tersebut	mengedepan	1
tertinggi_terdepan	tertinggi	terdepan	1
terus_me-ngedepankan	terus	me-ngedepankan	1
tetangga_depan	tetangga	depan	1
tetap_mengendepankan	tetap	mengendepankan	1
tetap_terdepan	tetap	terdepan	1
tetapi_kedepan	tetapi	kedepan	1
tetapi_menge-depankan	tetapi	menge-depankan	1
tiga_terdepan	tiga	terdepan	1
tinggi_kedepan	tinggi	kedepan	1
tombak_terdepannya	tombak	terdepannya	1
tubuh_depan	tubuh	depan	1
tugas_kedepan	tugas	kedepan	1
tugas_kedepannya	tugas	kedepannya	1
tulangan_depannya	tulangan	depannya	1
umum_depan	umum	depan	1
unjukrasa_depan	unjukrasa	depan	1
untuk_depan	untuk	depan	1
untuk_ke-depan	untuk	ke-depan	1
untuk_kedepankan	untuk	kedepankan	1
untuk_kekdepan	untuk	kekdepan	1
untuk_menge-depankan	untuk	menge-depankan	1
usaha_kedepannya	usaha	kedepannya	1
utama_mengedepankan	utama	mengedepankan	1
utuk_mengedepankan	utuk	mengedepankan	1
visi_kedepan	visi	kedepan	1
visi_kedepannya	visi	kedepannya	1
visinya_kedepan	visinya	kedepan	1
wajah_depannya	wajah	depannya	1
warga_me-ngedepankan	warga	me-ngedepankan	1
warga_mengedepankan	warga	mengedepankan	1
wilayah_depan	wilayah	depan	1
wilayah-wilayah_terdepan	wilayah-wilayah	terdepan	1
www.virginradiojakarta.com_kedepan	www.virginradiojakarta.com	kedepan	1
yaitu_kedepankan	yaitu	kedepankan	1
yakin_kedepannya	yakin	kedepannya	1
yakni_mengedepankan	yakni	mengedepankan	1
yang_depan	yang	depan	1
yang_di-kedepankan	yang	di-kedepankan	1
yang_didepan	yang	didepan	1
yang_me-ngedepankan	yang	me-ngedepankan	1
yang_mengedepan-kan	yang	mengedepan-kan	1
