ngram	w1	w2	n
masa_depan	masa	depan	1392
di_masa	di	masa	1012
pada_masa	pada	masa	576
masa_lalu	masa	lalu	473
masa_kini	masa	kini	205
masa_mendatang	masa	mendatang	198
masa_jabatan	masa	jabatan	194
masa_kampanye	masa	kampanye	170
selama_masa	selama	masa	165
masa_yang	masa	yang	158
untuk_masa	untuk	masa	152
memasuki_masa	memasuki	masa	151
dalam_masa	dalam	masa	146
dengan_masa	dengan	masa	128
dan_masa	dan	masa	109
masa_itu	masa	itu	108
masa_depannya	masa	depannya	100
dari_masa	dari	masa	97
masa_jabatannya	masa	jabatannya	93
masa_reses	masa	reses	92
masa_kerja	masa	kerja	86
masa_pensiun	masa	pensiun	85
menjalani_masa	menjalani	masa	84
sepanjang_masa	sepanjang	masa	83
ke_masa	ke	masa	73
masa_pemerintahan	masa	pemerintahan	67
masa_transisi	masa	transisi	63
sebelum_masa	sebelum	masa	56
masa_kecil	masa	kecil	53
saat_masa	saat	masa	52
sejak_masa	sejak	masa	52
akhir_masa	akhir	masa	49
masa_berlaku	masa	berlaku	48
masa_datang	masa	datang	48
masa_bakti	masa	bakti	47
habis_masa	habis	masa	46
masa_lampau	masa	lampau	46
masa_panen	masa	panen	44
masa_liburan	masa	liburan	42
adalah_masa	adalah	masa	41
masa-lah_ini	masa-lah	ini	41
setelah_masa	setelah	masa	41
hingga_masa	hingga	masa	39
masa_kepemimpinan	masa	kepemimpinan	39
yang_masa	yang	masa	38
masa_kecilnya	masa	kecilnya	35
masa_tahanan	masa	tahanan	35
demi_masa	demi	masa	34
di_masa-masa	di	masa-masa	33
masa_hukuman	masa	hukuman	33
masa_tugas	masa	tugas	32
tahun_masa	tahun	masa	32
masa_ke	masa	ke	31
masa_lalunya	masa	lalunya	31
masa_sekarang	masa	sekarang	31
melewati_masa	melewati	masa	31
memiliki_masa	memiliki	masa	31
bagi_masa	bagi	masa	30
berakhirnya_masa	berakhirnya	masa	28
masa_berlakunya	masa	berlakunya	28
masa_sidang	masa	sidang	28
mengalami_masa	mengalami	masa	28
masa_penjajahan	masa	penjajahan	27
mengakhiri_masa	mengakhiri	masa	27
pemimpin_masa	pemimpin	masa	27
karena_masa	karena	masa	26
masa_ini	masa	ini	26
masa_sulit	masa	sulit	26
generasi_masa	generasi	masa	25
masa_injury	masa	injury	25
masa_kehamilan	masa	kehamilan	25
memperpanjang_masa	memperpanjang	masa	25
masa_tanam	masa	tanam	24
masa_tugasnya	masa	tugasnya	24
terhadap_masa	terhadap	masa	24
masa_percobaan	masa	percobaan	23
masa-masa_sulit	masa-masa	sulit	23
menentukan_masa	menentukan	masa	23
menghabiskan_masa	menghabiskan	masa	23
perpanjangan_masa	perpanjangan	masa	23
tentang_masa	tentang	masa	23
masa_libur	masa	libur	22
ada_masa	ada	masa	21
ketika_masa	ketika	masa	21
masa_awal	masa	awal	21
masa_berkabung	masa	berkabung	21
masa_bodoh	masa	bodoh	21
masa_pendaftaran	masa	pendaftaran	21
masa_silam	masa	silam	21
awal_masa	awal	masa	20
bulan_masa	bulan	masa	20
masa_kepemimpinannya	masa	kepemimpinannya	20
masa_pemulihan	masa	pemulihan	20
masa_persiapan	masa	persiapan	20
mengenai_masa	mengenai	masa	20
merupakan_masa	merupakan	masa	20
sampai_masa	sampai	masa	20
terkait_masa	terkait	masa	20
sisa_masa	sisa	masa	19
masa_kerjanya	masa	kerjanya	18
masa_kontrak	masa	kontrak	18
masa_perpanjangan	masa	perpanjangan	18
masa_tunggu	masa	tunggu	18
masa_uji	masa	uji	18
media_masa	media	masa	18
bahwa_masa	bahwa	masa	17
berakhir_masa	berakhir	masa	17
masa_penahanan	masa	penahanan	17
masa_angkutan	masa	angkutan	16
masa_di	masa	di	16
masa_kejayaan	masa	kejayaan	16
masa_orientasi	masa	orientasi	16
masa_pemerintahannya	masa	pemerintahannya	16
masa_tenang	masa	tenang	16
masa-masa_yang	masa-masa	yang	16
mengalami_masa-masa	mengalami	masa-masa	16
menjadi_masa	menjadi	masa	16
pada_masa-masa	pada	masa-masa	16
basis_masa	basis	masa	15
lewat_masa	lewat	masa	15
masa_de-pan	masa	de-pan	15
masa_kanak-kanak	masa	kanak-kanak	15
masa_muda	masa	muda	15
masa_orde	masa	orde	15
melihat_masa	melihat	masa	15
menikmati_masa	menikmati	masa	15
punya_masa	punya	masa	15
sebagai_masa	sebagai	masa	15
ini_masa	ini	masa	14
masa_remaja	masa	remaja	14
masuk_masa	masuk	masa	14
menatap_masa	menatap	masa	14
mengatakan_masa	mengatakan	masa	14
menyelesaikan_masa	menyelesaikan	masa	14
akan_masa	akan	masa	13
masa_aktif	masa	aktif	13
masa_tanggap	masa	tanggap	13
masa_tua	masa	tua	13
membangun_masa	membangun	masa	13
pengurangan_masa	pengurangan	masa	13
kehidupan_masa	kehidupan	masa	12
masa_akhir	masa	akhir	12
masa_cuti	masa	cuti	12
masa_persidangan	masa	persidangan	12
memanfaatkan_masa	memanfaatkan	masa	12
memikirkan_masa	memikirkan	masa	12
menghadapi_masa	menghadapi	masa	12
menuju_masa	menuju	masa	12
sejarah_masa	sejarah	masa	12
atau_masa	atau	masa	11
masa_keemasan	masa	keemasan	11
masa_krisis	masa	krisis	11
masa_reformasi	masa	reformasi	11
masa-masa_mendatang	masa-masa	mendatang	11
ada_masa-lah	ada	masa-lah	10
hari_masa	hari	masa	10
lini_masa	lini	masa	10
maka_masa	maka	masa	10
masa_baktinya	masa	baktinya	10
masa_kolonial	masa	kolonial	10
masa_kontraknya	masa	kontraknya	10
masa_kritis	masa	kritis	10
masa_puasa	masa	puasa	10
masa_waktu	masa	waktu	10
masa-masa_awal	masa-masa	awal	10
mengingat_masa	mengingat	masa	10
mobil_masa	mobil	masa	10
remaja_masa	remaja	masa	10
suatu_masa	suatu	masa	10
energi_masa	energi	masa	9
itu_masa	itu	masa	9
lagi_masa	lagi	masa	9
masa_akan	masa	akan	9
masa_aksi	masa	aksi	9
masa_dewasa	masa	dewasa	9
masa_izin	masa	izin	9
masa_kepengurusan	masa	kepengurusan	9
masa_pemeliharaan	masa	pemeliharaan	9
masa_perang	masa	perang	9
masa_saya	masa	saya	9
masa_sekolah	masa	sekolah	9
masa_studi	masa	studi	9
masa_tumbuh	masa	tumbuh	9
mengancam_masa	mengancam	masa	9
menghancurkan_masa	menghancurkan	masa	9
mengisi_masa	mengisi	masa	9
menjelang_masa	menjelang	masa	9
merusak_masa	merusak	masa	9
seperti_masa	seperti	masa	9
soal_masa	soal	masa	9
wajah_masa	wajah	masa	9
besar_masa	besar	masa	8
lama_masa	lama	masa	8
masa_dengan	masa	dengan	8
masa_istirahat	masa	istirahat	8
masa_kekuasaan	masa	kekuasaan	8
masa_pacaran	masa	pacaran	8
masa_pakai	masa	pakai	8
masa_pendudukan	masa	pendudukan	8
masa_pertumbuhan	masa	pertumbuhan	8
masa_remajanya	masa	remajanya	8
masa-lah_yang	masa-lah	yang	8
masih_masa	masih	masa	8
me-masuki_masa	me-masuki	masa	8
melalui_masa	melalui	masa	8
melepas_masa	melepas	masa	8
memberikan_masa	memberikan	masa	8
penentu_masa	penentu	masa	8
pertama_masa	pertama	masa	8
agar_masa	agar	masa	7
atas_masa	atas	masa	7
dengan_masa-lah	dengan	masa-lah	7
dikurangi_masa	dikurangi	masa	7
jika_masa	jika	masa	7
juga_masa	juga	masa	7
karena_masa-lah	karena	masa-lah	7
kenangan_masa	kenangan	masa	7
kesalahan_masa	kesalahan	masa	7
masa_belajar	masa	belajar	7
masa_dan	masa	dan	7
masa_hidup	masa	hidup	7
masa_jaya	masa	jaya	7
masa_kan	masa	kan	7
masa_kita	masa	kita	7
masa_lima	masa	lima	7
masa_pembangunan	masa	pembangunan	7
masa_pemilihan	masa	pemilihan	7
masa_pendidikan	masa	pendidikan	7
masa_peralihan	masa	peralihan	7
masa_perawatan	masa	perawatan	7
masa_periode	masa	periode	7
masa_sewa	masa	sewa	7
masa_sosialisasi	masa	sosialisasi	7
masa_tahun	masa	tahun	7
melewati_masa-masa	melewati	masa-masa	7
mema-suki_masa	mema-suki	masa	7
mendekati_masa	mendekati	masa	7
mengenang_masa	mengenang	masa	7
menyiapkan_masa	menyiapkan	masa	7
muda_masa	muda	masa	7
pengalaman_masa	pengalaman	masa	7
periode_masa	periode	masa	7
satu_masa	satu	masa	7
selesai_masa	selesai	masa	7
dia_masa	dia	masa	6
dipotong_masa	dipotong	masa	6
dosa_masa	dosa	masa	6
habisnya_masa	habisnya	masa	6
harapan_masa	harapan	masa	6
jaminan_masa	jaminan	masa	6
kepentingan_masa	kepentingan	masa	6
masa_dia	masa	dia	6
masa_hidupnya	masa	hidupnya	6
masa_ja-batan	masa	ja-batan	6
masa_jayanya	masa	jayanya	6
masa_karantina	masa	karantina	6
masa_kemerdekaan	masa	kemerdekaan	6
masa_lajang	masa	lajang	6
masa_pelayanan	masa	pelayanan	6
masa_pendukung	masa	pendukung	6
masa_promo	masa	promo	6
masa_promosi	masa	promosi	6
masa_tambahan	masa	tambahan	6
masa_tuanya	masa	tuanya	6
mengubah_masa	mengubah	masa	6
mengumumkan_masa	mengumumkan	masa	6
menyongsong_masa	menyongsong	masa	6
meski_masa	meski	masa	6
pe-mimpin_masa	pe-mimpin	masa	6
pembukaan_masa	pembukaan	masa	6
peninggalan_masa	peninggalan	masa	6
penutupan_masa	penutupan	masa	6
rencana_masa	rencana	masa	6
romantisme_masa	romantisme	masa	6
rumah_masa	rumah	masa	6
terakhir_masa	terakhir	masa	6
usai_masa	usai	masa	6
waktu_masa	waktu	masa	6
adalah_masa-masa	adalah	masa-masa	5
arah_masa	arah	masa	5
bagaimana_masa	bagaimana	masa	5
dalam_masa-masa	dalam	masa-masa	5
dibandingkan_masa	dibandingkan	masa	5
kali_masa	kali	masa	5
kebutuhan_masa	kebutuhan	masa	5
lalu_masa	lalu	masa	5
masa_anak-anak	masa	anak-anak	5
masa_arus	masa	arus	5
masa_dalam	masa	dalam	5
masa_emas	masa	emas	5
masa_hari	masa	hari	5
masa_injuri	masa	injuri	5
masa_jeda	masa	jeda	5
masa_kata	masa	kata	5
masa_kedaluwarsa	masa	kedaluwarsa	5
masa_kredit	masa	kredit	5
masa_kuliah	masa	kuliah	5
masa_mau	masa	mau	5
masa_mudanya	masa	mudanya	5
masa_pakainya	masa	pakainya	5
masa_peminjaman	masa	peminjaman	5
masa_pen-siun	masa	pen-siun	5
masa_pengabdiannya	masa	pengabdiannya	5
masa_perjuangan	masa	perjuangan	5
masa_purna	masa	purna	5
masa_sebelum	masa	sebelum	5
masa_tersebut	masa	tersebut	5
masa_tiga	masa	tiga	5
masa_tinggal	masa	tinggal	5
masa_untuk	masa	untuk	5
masa-masa_paling	masa-masa	paling	5
melakukan_masa	melakukan	masa	5
mempersiapkan_masa	mempersiapkan	masa	5
mempunyai_masa	mempunyai	masa	5
memulai_masa	memulai	masa	5
mencapai_masa	mencapai	masa	5
menjadi_masa-lah	menjadi	masa-lah	5
menunggu_masa	menunggu	masa	5
menyelesaikan_masa-lah	menyelesaikan	masa-lah	5
perempuan_masa	perempuan	masa	5
serta_masa	serta	masa	5
tanpa_masa	tanpa	masa	5
tantangan_masa	tantangan	masa	5
tapi_masa	tapi	masa	5
teman_masa	teman	masa	5
trauma_masa	trauma	masa	5
anak_masa	anak	masa	4
antara_masa	antara	masa	4
baik_masa	baik	masa	4
bangsa_masa	bangsa	masa	4
bersikap_masa	bersikap	masa	4
dua_masa	dua	masa	4
hanya_masa	hanya	masa	4
kehilangan_masa	kehilangan	masa	4
kelangsungan_masa	kelangsungan	masa	4
kembali_masa	kembali	masa	4
klub_masa	klub	masa	4
kota_masa	kota	masa	4
lamanya_masa	lamanya	masa	4
mana_masa	mana	masa	4
masa_bhakti	masa	bhakti	4
masa_damai	masa	damai	4
masa_dari	masa	dari	4
masa_dinas	masa	dinas	4
masa_dulu	masa	dulu	4
masa_garansi	masa	garansi	4
masa_inkubasi	masa	inkubasi	4
masa_kampanyenya	masa	kampanyenya	4
masa_keemasannya	masa	keemasannya	4
masa_kekinian	masa	kekinian	4
masa_kerajaan	masa	kerajaan	4
masa_khidmat	masa	khidmat	4
masa_menda-tang	masa	menda-tang	4
masa_menopause	masa	menopause	4
masa_paling	masa	paling	4
masa_pancaroba	masa	pancaroba	4
masa_penantian	masa	penantian	4
masa_pendidikannya	masa	pendidikannya	4
masa_pengenalan	masa	pengenalan	4
masa_pengobatan	masa	pengobatan	4
masa_pensiunnya	masa	pensiunnya	4
masa_penugasan	masa	penugasan	4
masa_penyembuhan	masa	penyembuhan	4
masa_perbaikan	masa	perbaikan	4
masa_pergantian	masa	pergantian	4
masa_perubahan	masa	perubahan	4
masa_pra	masa	pra	4
masa_revolusi	masa	revolusi	4
masa_seperti	masa	seperti	4
masa_tahanannya	masa	tahanannya	4
masa_tenggang	masa	tenggang	4
masa_tidak	masa	tidak	4
masa-lah_dengan	masa-lah	dengan	4
masa-lah_di	masa-lah	di	4
masa-lah_tersebut	masa-lah	tersebut	4
masyarakat_masa	masyarakat	masa	4
maupun_masa	maupun	masa	4
melanjutkan_masa	melanjutkan	masa	4
melupakan_masa	melupakan	masa	4
memang_masa	memang	masa	4
membawa_masa	membawa	masa	4
membuat_masa	membuat	masa	4
mempertimbangkan_masa	mempertimbangkan	masa	4
memprediksi_masa	memprediksi	masa	4
memutuskan_masa	memutuskan	masa	4
menetapkan_masa	menetapkan	masa	4
mengatasi_masa-lah	mengatasi	masa-lah	4
mengetahui_masa	mengetahui	masa	4
menginjak_masa	menginjak	masa	4
menilai_masa	menilai	masa	4
menjamin_masa	menjamin	masa	4
menyangkut_masa	menyangkut	masa	4
menyatakan_masa	menyatakan	masa	4
meraih_masa	meraih	masa	4
merancang_masa	merancang	masa	4
ribu_masa	ribu	masa	4
sebab_masa	sebab	masa	4
sehingga_masa	sehingga	masa	4
sesuai_masa	sesuai	masa	4
tahu_masa	tahu	masa	4
untuk_masa-lah	untuk	masa-lah	4
Ã¢_masa	Ã¢	masa	3
adanya_masa	adanya	masa	3
akhir-akhir_masa	akhir-akhir	masa	3
aksi_masa	aksi	masa	3
aneh_masa	aneh	masa	3
apalagi_masa	apalagi	masa	3
bagian_masa	bagian	masa	3
boleh_masa	boleh	masa	3
bukan_masa-lah	bukan	masa-lah	3
cita-cita_masa	cita-cita	masa	3
cuti_masa	cuti	masa	3
da-lam_masa	da-lam	masa	3
dari_masa-masa	dari	masa-masa	3
demikian_masa	demikian	masa	3
dengan_masa-masa	dengan	masa-masa	3
diketahui_masa	diketahui	masa	3
dimulainya_masa	dimulainya	masa	3
dinamika_masa	dinamika	masa	3
fesyen_masa	fesyen	masa	3
ialah_masa	ialah	masa	3
idola_masa	idola	masa	3
impian_masa	impian	masa	3
industri_masa	industri	masa	3
investasi_masa	investasi	masa	3
kalau_masa	kalau	masa	3
karier_masa	karier	masa	3
kedua_masa	kedua	masa	3
kejayaan_masa	kejayaan	masa	3
kelanjutan_masa	kelanjutan	masa	3
kerumunan_masa	kerumunan	masa	3
ketidakpastian_masa	ketidakpastian	masa	3
kondisi_masa	kondisi	masa	3
lain_masa	lain	masa	3
masa_belum	masa	belum	3
masa_berakhir	masa	berakhir	3
masa_berakhirnya	masa	berakhirnya	3
masa_berikutnya	masa	berikutnya	3
masa_bulan	masa	bulan	3
masa_cuma	masa	cuma	3
masa_darurat	masa	darurat	3
masa_demokrasi	masa	demokrasi	3
masa_enam	masa	enam	3
masa_hamil	masa	hamil	3
masa_harus	masa	harus	3
masa_jaba-tannya	masa	jaba-tannya	3
masa_jabatanya	masa	jabatanya	3
masa_kalender	masa	kalender	3
masa_kanak	masa	kanak	3
masa_ke-pemimpinan	masa	ke-pemimpinan	3
masa_kehidupan	masa	kehidupan	3
masa_kejayaannya	masa	kejayaannya	3
masa_keterbukaan	masa	keterbukaan	3
masa_ketika	masa	ketika	3
masa_lebaran	masa	lebaran	3
masa_liburnya	masa	liburnya	3
masa_men-datang	masa	men-datang	3
masa_menstruasi	masa	menstruasi	3
masa_mo	masa	mo	3
masa_modern	masa	modern	3
masa_mudik	masa	mudik	3
masa_nifas	masa	nifas	3
masa_paruh	masa	paruh	3
masa_pembentukan	masa	pembentukan	3
masa_pemerin-tahannya	masa	pemerin-tahannya	3
masa_pemerintah	masa	pemerintah	3
masa_pemilu	masa	pemilu	3
masa_penawaran	masa	penawaran	3
masa_pendaf-taran	masa	pendaf-taran	3
masa_penempatan	masa	penempatan	3
masa_peradaban	masa	peradaban	3
masa_pilkada	masa	pilkada	3
masa_pra-industri	masa	pra-industri	3
masa_produksi	masa	produksi	3
masa_pubertas	masa	pubertas	3
masa_puncak	masa	puncak	3
masa_rawan	masa	rawan	3
masa_rehat	masa	rehat	3
masa_resesi	masa	resesi	3
masa_riil	masa	riil	3
masa_saja	masa	saja	3
masa_satu	masa	satu	3
masa_sebelumnya	masa	sebelumnya	3
masa_senja	masa	senja	3
masa_sewanya	masa	sewanya	3
masa_sih	masa	sih	3
masa_simpan	masa	simpan	3
masa_studinya	masa	studinya	3
masa_surut	masa	surut	3
masa_tanpa	masa	tanpa	3
masa_tayang	masa	tayang	3
masa_tu-gasnya	masa	tu-gasnya	3
masa_ujian	masa	ujian	3
masa_usia	masa	usia	3
masa-masa_lalu	masa-masa	lalu	3
masalah_masa	masalah	masa	3
me-rancang_masa	me-rancang	masa	3
membahas_masa-lah	membahas	masa-lah	3
membayangkan_masa	membayangkan	masa	3
membicarakan_masa	membicarakan	masa	3
membuka_masa	membuka	masa	3
membutuhkan_masa	membutuhkan	masa	3
memperbaiki_masa	memperbaiki	masa	3
menambahkan_masa	menambahkan	masa	3
menawarkan_masa	menawarkan	masa	3
menciptakan_masa	menciptakan	masa	3
menegaskan_masa	menegaskan	masa	3
mengakui_masa	mengakui	masa	3
mengawali_masa	mengawali	masa	3
mengenai_masa-lah	mengenai	masa-lah	3
menggapai_masa	menggapai	masa	3
menghadirkan_masa	menghadirkan	masa	3
mengingat_masa-masa	mengingat	masa-masa	3
mengisahkan_masa	mengisahkan	masa	3
mengungkap_masa	mengungkap	masa	3
mengungkit-ungkit_masa	mengungkit-ungkit	masa	3
menja-lani_masa	menja-lani	masa	3
menjalankan_masa	menjalankan	masa	3
menjelaskan_masa	menjelaskan	masa	3
menyambut_masa	menyambut	masa	3
menyangkut_masa-lah	menyangkut	masa-lah	3
menyelamatkan_masa	menyelamatkan	masa	3
menyikapi_masa-lah	menyikapi	masa-lah	3
meyakini_masa	meyakini	masa	3
namun_masa	namun	masa	3
orang_masa	orang	masa	3
panjang_masa	panjang	masa	3
pelaksanaan_masa	pelaksanaan	masa	3
pembangunan_masa	pembangunan	masa	3
pembatasan_masa	pembatasan	masa	3
persiapan_masa	persiapan	masa	3
pikir_masa	pikir	masa	3
pula_masa	pula	masa	3
ribuan_masa	ribuan	masa	3
saja_masa	saja	masa	3
sedang_masa	sedang	masa	3
semenjak_masa	semenjak	masa	3
setahun_masa	setahun	masa	3
suasana_masa	suasana	masa	3
sudah_masa	sudah	masa	3
tahapan_masa	tahapan	masa	3
teknologi_masa	teknologi	masa	3
tengah-tengah_masa	tengah-tengah	masa	3
tercantum_masa	tercantum	masa	3
teringat_masa	teringat	masa	3
terkait_masa-lah	terkait	masa-lah	3
tiga_masa	tiga	masa	3
yakni_masa	yakni	masa	3
agenda_masa	agenda	masa	2
akhirnya_masa	akhirnya	masa	2
anak-anak_masa	anak-anak	masa	2
ancaman_masa	ancaman	masa	2
andalan_masa	andalan	masa	2
apa_masa	apa	masa	2
arti_masa	arti	masa	2
aset_masa	aset	masa	2
asumsi_masa	asumsi	masa	2
atlet_masa	atlet	masa	2
bahkan_masa	bahkan	masa	2
beberapa_masa	beberapa	masa	2
begitu_masa	begitu	masa	2
bekal_masa	bekal	masa	2
ber-akhirnya_masa	ber-akhirnya	masa	2
berakhir-nya_masa	berakhir-nya	masa	2
berarti_masa	berarti	masa	2
berat_masa	berat	masa	2
berbagai_masa-lah	berbagai	masa-lah	2
berpikir_masa	berpikir	masa	2
bicara_masa	bicara	masa	2
bila_masa	bila	masa	2
bintang_masa	bintang	masa	2
bola_masa	bola	masa	2
budaya_masa	budaya	masa	2
bukan_masa	bukan	masa	2
cerdas_masa	cerdas	masa	2
cerita_masa	cerita	masa	2
dalam_masa-lah	dalam	masa-lah	2
dan_masa-masa	dan	masa-masa	2
dari_masa-lah	dari	masa-lah	2
daripada_masa	daripada	masa	2
diberikan_masa	diberikan	masa	2
disebut_masa	disebut	masa	2
era_masa	era	masa	2
estafet_masa	estafet	masa	2
fair_masa	fair	masa	2
foto_masa	foto	masa	2
gambaran_masa	gambaran	masa	2
gaul_masa	gaul	masa	2
gaya_masa	gaya	masa	2
gejolak_masa	gejolak	masa	2
gereja_masa	gereja	masa	2
hanya_masa-lah	hanya	masa-lah	2
ingin_masa	ingin	masa	2
inilah_masa	inilah	masa	2
inspirasi_masa	inspirasi	masa	2
jadi_masa	jadi	masa	2
jalan_masa	jalan	masa	2
jejak_masa	jejak	masa	2
jika_masa-lah	jika	masa-lah	2
kader_masa	kader	masa	2
kan_masa	kan	masa	2
kapan_masa	kapan	masa	2
kasus_masa	kasus	masa	2
ke_masa-masa	ke	masa-masa	2
keberhasilan_masa	keberhasilan	masa	2
keberlangsungan_masa	keberlangsungan	masa	2
keempat_masa	keempat	masa	2
kejadian_masa	kejadian	masa	2
kekayaan_masa	kekayaan	masa	2
kemudian_masa	kemudian	masa	2
kemungkinan_masa	kemungkinan	masa	2
kepada_masa	kepada	masa	2
kepastian_masa	kepastian	masa	2
kepengurusan_masa	kepengurusan	masa	2
keras_masa	keras	masa	2
ketiga_masa	ketiga	masa	2
ketika_masa-lah	ketika	masa-lah	2
ketimbang_masa	ketimbang	masa	2
kira_masa	kira	masa	2
konteks_masa	konteks	masa	2
lokal_masa	lokal	masa	2
manfaatkan_masa	manfaatkan	masa	2
manusia_masa	manusia	masa	2
masa_ada	masa	ada	2
masa_adaptasi	masa	adaptasi	2
masa_agresi	masa	agresi	2
masa_anggaran	masa	anggaran	2
masa_antara	masa	antara	2
masa_atau	masa	atau	2
masa_bayar	masa	bayar	2
masa_berkuasanya	masa	berkuasanya	2
masa_bermain	masa	bermain	2
masa_bu-lan	masa	bu-lan	2
masa_buat	masa	buat	2
masa_calon	masa	calon	2
masa_dewasanya	masa	dewasanya	2
masa_dimana	masa	dimana	2
masa_dinasnya	masa	dinasnya	2
masa_disuruh	masa	disuruh	2
masa_dua	masa	dua	2
masa_duka	masa	duka	2
masa_edarnya	masa	edarnya	2
masa_empat	masa	empat	2
masa_era	masa	era	2
masa_erupsi	masa	erupsi	2
masa_evaluasi	masa	evaluasi	2
masa_free-agency	masa	free-agency	2
masa_gadisnya	masa	gadisnya	2
masa_gelap	masa	gelap	2
masa_haid	masa	haid	2
masa_ia	masa	ia	2
masa_idahnya	masa	idahnya	2
masa_inkubasinya	masa	inkubasinya	2
masa_iya	masa	iya	2
masa_ja-batannya	masa	ja-batannya	2
masa_jahiliah	masa	jahiliah	2
masa_jelas	masa	jelas	2
masa_kabinet	masa	kabinet	2
masa_kampa-nye	masa	kampa-nye	2
masa_keanggotaan	masa	keanggotaan	2
masa_kedaluwarsanya	masa	kedaluwarsanya	2
masa_kelam	masa	kelam	2
masa_kemarau	masa	kemarau	2
masa_kepe-mimpinan	masa	kepe-mimpinan	2
masa_kepelatihan	masa	kepelatihan	2
masa_kepengurusannya	masa	kepengurusannya	2
masa_kepresidenan	masa	kepresidenan	2
masa_ker-ja	masa	ker-ja	2
masa_kritisnya	masa	kritisnya	2
masa_lah	masa	lah	2
masa_lajangnya	masa	lajangnya	2
masa_langsung	masa	langsung	2
masa_lanjut	masa	lanjut	2
masa_launching	masa	launching	2
masa_liburannya	masa	liburannya	2
masa_low	masa	low	2
masa_magang	masa	magang	2
masa_malah	masa	malah	2
masa_melakukan	masa	melakukan	2
masa_membuat	masa	membuat	2
masa_mengandung	masa	mengandung	2
masa_menit	masa	menit	2
masa_menjadi	masa	menjadi	2
masa_menjalani	masa	menjalani	2
masa_menjelang	masa	menjelang	2
masa_menyusui	masa	menyusui	2
masa_minggu	masa	minggu	2
masa_moratorium	masa	moratorium	2
masa_operasi	masa	operasi	2
masa_operasional	masa	operasional	2
masa_orang	masa	orang	2
masa_pabrik	masa	pabrik	2
masa_paceklik	masa	paceklik	2
masa_pada	masa	pada	2
masa_pasca-Nabi	masa	pasca-Nabi	2
masa_pe-merintahan	masa	pe-merintahan	2
masa_pe-nahanan	masa	pe-nahanan	2
masa_pelarian	masa	pelarian	2
masa_pelatihan	masa	pelatihan	2
masa_pembayaran	masa	pembayaran	2
masa_pembebasan	masa	pembebasan	2
masa_peme-rintahan	masa	peme-rintahan	2
masa_peminjamannya	masa	peminjamannya	2
masa_pemulangan	masa	pemulangan	2
masa_penahanan-nya	masa	penahanan-nya	2
masa_pencalonan	masa	pencalonan	2
masa_penentuan	masa	penentuan	2
masa_pengabdian	masa	pengabdian	2
masa_pengangkutan	masa	pengangkutan	2
masa_pengembalian	masa	pengembalian	2
masa_penggunaan	masa	penggunaan	2
masa_penindakan	masa	penindakan	2
masa_penyelidikan	masa	penyelidikan	2
masa_penyesuaian	masa	penyesuaian	2
masa_pergolakan	masa	pergolakan	2
masa_perkembangannya	masa	perkembangannya	2
masa_pileg	masa	pileg	2
masa_pinjaman	masa	pinjaman	2
masa_pinjamannya	masa	pinjamannya	2
masa_prajabatan	masa	prajabatan	2
masa_prasejarah	masa	prasejarah	2
masa_pre-order	masa	pre-order	2
masa_puncaknya	masa	puncaknya	2
masa_registrasi	masa	registrasi	2
masa_rehatnya	masa	rehatnya	2
masa_repayment	masa	repayment	2
masa_resesnya	masa	resesnya	2
masa_saat	masa	saat	2
masa_sanggah	masa	sanggah	2
masa_sebagai	masa	sebagai	2
masa_seiring	masa	seiring	2
masa_seka-rang	masa	seka-rang	2
masa_selalu	masa	selalu	2
masa_selanjutnya	masa	selanjutnya	2
masa_seorang	masa	seorang	2
masa_setelah	masa	setelah	2
masa_siaga	masa	siaga	2
masa_so	masa	so	2
masa_subur	masa	subur	2
masa_sudah	masa	sudah	2
masa_sukar	masa	sukar	2
masa_suram	masa	suram	2
masa_tax	masa	tax	2
masa_tenggat	masa	tenggat	2
masa_terus	masa	terus	2
masa_tukas	masa	tukas	2
masa_verifikasi	masa	verifikasi	2
masa_weekend	masa	weekend	2
masa-lah_aset	masa-lah	aset	2
masa-lah_bagi	masa-lah	bagi	2
masa-lah_baru	masa-lah	baru	2
masa-lah_dana	masa-lah	dana	2
masa-lah_ekonomi	masa-lah	ekonomi	2
masa-lah_jika	masa-lah	jika	2
masa-lah_kekurangan	masa-lah	kekurangan	2
masa-lah_komitmen	masa-lah	komitmen	2
masa-lah_perekonomian	masa-lah	perekonomian	2
masa-lah_secara	masa-lah	secara	2
masa-lah_soal	masa-lah	soal	2
masa-lah_ujarnya	masa-lah	ujarnya	2
masa-masa_bulan	masa-masa	bulan	2
masa-masa_di	masa-masa	di	2
masa-masa_hari	masa-masa	hari	2
masa-masa_itu	masa-masa	itu	2
masa-masa_jet	masa-masa	jet	2
masa-masa_kampanye	masa-masa	kampanye	2
masa-masa_kecil	masa-masa	kecil	2
masa-masa_keemasan	masa-masa	keemasan	2
masa-masa_kejayaan	masa-masa	kejayaan	2
masa-masa_kritis	masa-masa	kritis	2
masa-masa_penuh	masa-masa	penuh	2
masa-masa_saat	masa-masa	saat	2
masa-masa_sebelumnya	masa-masa	sebelumnya	2
masa-masa_seperti	masa-masa	seperti	2
masa-masa_sukar	masa-masa	sukar	2
masa-masa_suram	masa-masa	suram	2
masa-masa_tersebut	masa-masa	tersebut	2
masa-masa_ujian	masa-masa	ujian	2
masa-masa_untuk	masa-masa	untuk	2
masuknya_masa	masuknya	masa	2
me-nentukan_masa	me-nentukan	masa	2
me-ngenai_masa	me-ngenai	masa	2
me-rupakan_masa	me-rupakan	masa	2
melaksanakan_masa	melaksanakan	masa	2
melaporkan_masa-lah	melaporkan	masa-lah	2
melebihi_masa	melebihi	masa	2
membahas_masa	membahas	masa	2
membahayakan_masa	membahayakan	masa	2
membantu_masa	membantu	masa	2
memberlakukan_masa	memberlakukan	masa	2
membidangi_masa-lah	membidangi	masa-lah	2
memotong_masa	memotong	masa	2
mempercepat_masa	mempercepat	masa	2
memperpendek_masa	memperpendek	masa	2
mempertanyakan_masa	mempertanyakan	masa	2
mempertaruhkan_masa	mempertaruhkan	masa	2
menambah_masa	menambah	masa	2
menata_masa	menata	masa	2
mencakup_masa	mencakup	masa	2
mendukung_masa	mendukung	masa	2
meng-hadapi_masa	meng-hadapi	masa	2
mengamankan_masa	mengamankan	masa	2
mengangkat_masa-lah	mengangkat	masa-lah	2
mengawal_masa	mengawal	masa	2
mengejar_masa	mengejar	masa	2
menggunakan_masa	menggunakan	masa	2
menghadapi_masa-lah	menghadapi	masa-lah	2
menginginkan_masa	menginginkan	masa	2
mengkhawatirkan_masa	mengkhawatirkan	masa	2
mengorbankan_masa	mengorbankan	masa	2
mengungkapkan_masa	mengungkapkan	masa	2
mengusulkan_masa	mengusulkan	masa	2
menikmati_masa-masa	menikmati	masa-masa	2
meningkatkan_masa	meningkatkan	masa	2
menjaga_masa	menjaga	masa	2
menjanjikan_masa	menjanjikan	masa	2
menjemput_masa	menjemput	masa	2
menutup_masa	menutup	masa	2
menyikapi_masa	menyikapi	masa	2
menyusul_masa	menyusul	masa	2
merenda_masa	merenda	masa	2
merupakan_masa-masa	merupakan	masa-masa	2
mewujudkan_masa	mewujudkan	masa	2
militer_masa	militer	masa	2
mimpi_masa	mimpi	masa	2
mobil-mobil_masa	mobil-mobil	masa	2
modern_masa	modern	masa	2
moril_masa	moril	masa	2
motor_masa	motor	masa	2
mulai_masa	mulai	masa	2
musik_masa	musik	masa	2
nasional_masa	nasional	masa	2
negara_masa	negara	masa	2
nilai_masa	nilai	masa	2
oleh_masa	oleh	masa	2
otoma-tis_masa	otoma-tis	masa	2
pada_masa-lah	pada	masa-lah	2
pahlawan_masa	pahlawan	masa	2
pasca_masa	pasca	masa	2
pembalap_masa	pembalap	masa	2
pengerahan_masa	pengerahan	masa	2
pengganti_masa	pengganti	masa	2
penghargaan_masa	penghargaan	masa	2
penguasa_masa	penguasa	masa	2
penonton_masa	penonton	masa	2
penumpang_masa	penumpang	masa	2
per-panjangan_masa	per-panjangan	masa	2
percaya_masa	percaya	masa	2
peristiwa_masa	peristiwa	masa	2
permainan_masa	permainan	masa	2
pernikahan_masa	pernikahan	masa	2
pertanian_masa	pertanian	masa	2
pertimbangan_masa	pertimbangan	masa	2
perubahan_masa	perubahan	masa	2
pimpinan_masa	pimpinan	masa	2
politik_masa	politik	masa	2
presiden_masa	presiden	masa	2
produk_masa	produk	masa	2
produksi_masa	produksi	masa	2
pukul_masa	pukul	masa	2
puluhan_masa	puluhan	masa	2
rata-rata_masa	rata-rata	masa	2
red_masa	red	masa	2
reguler_masa	reguler	masa	2
saat_masa-masa	saat	masa-masa	2
sadar_masa	sadar	masa	2
sebe-lum_masa	sebe-lum	masa	2
sebelumnya_masa	sebelumnya	masa	2
sebuah_masa	sebuah	masa	2
sedangkan_masa	sedangkan	masa	2
sekaligus_masa	sekaligus	masa	2
sela-ma_masa	sela-ma	masa	2
selepas_masa	selepas	masa	2
seluruh_masa	seluruh	masa	2
separuh_masa	separuh	masa	2
seputar_masa	seputar	masa	2
serta_masa-lah	serta	masa-lah	2
setiap_masa	setiap	masa	2
situasi_masa	situasi	masa	2
spekulasi_masa	spekulasi	masa	2
susah_masa	susah	masa	2
syarat_masa	syarat	masa	2
tabungan_masa	tabungan	masa	2
tak_masa-lah	tak	masa-lah	2
tawarkan_masa	tawarkan	masa	2
tengah_masa	tengah	masa	2
terbaik_masa	terbaik	masa	2
terjebak_masa	terjebak	masa	2
termasuk_masa	termasuk	masa	2
terutama_masa	terutama	masa	2
tetapi_masa	tetapi	masa	2
tiba_masa	tiba	masa	2
tokoh_masa	tokoh	masa	2
tokoh-tokoh_masa	tokoh-tokoh	masa	2
tren_masa	tren	masa	2
urusan_masa	urusan	masa	2
usia_masa	usia	masa	2
visi_masa	visi	masa	2
wanita_masa	wanita	masa	2
2Ne1_masa	2Ne1	masa	1
3T_masa	3T	masa	1
ada_masa-nya	ada	masa-nya	1
ada-lah_masa	ada-lah	masa	1
aduh_masa	aduh	masa	1
agar_masa-lahnya	agar	masa-lahnya	1
agar_masa-masa	agar	masa-masa	1
ahli_masa-lah	ahli	masa-lah	1
aja_masa-masa	aja	masa-masa	1
akan_masa-masa	akan	masa-masa	1
akhri_masa	akhri	masa	1
akibat_masa	akibat	masa	1
amuk_masa	amuk	masa	1
amukan_masa	amukan	masa	1
anaknya_masa	anaknya	masa	1
anggapan_masa	anggapan	masa	1
anggaran_masa	anggaran	masa	1
antaranya_masa	antaranya	masa	1
apa-lagi_masa	apa-lagi	masa	1
apakah_masa	apakah	masa	1
artinya_masa	artinya	masa	1
arus_masa	arus	masa	1
asal-usul_masa	asal-usul	masa	1
aspirasi_masa	aspirasi	masa	1
atlet-atlet_masa	atlet-atlet	masa	1
atribut_masa	atribut	masa	1
bagaimanapun_masa-lah	bagaimanapun	masa-lah	1
bah-wa_masa-lah	bah-wa	masa-lah	1
bahwa_masa-lah	bahwa	masa-lah	1
baiknya_masa-lah	baiknya	masa-lah	1
ban_masa	ban	masa	1
ban-ding_masa	ban-ding	masa	1
bangun_masa	bangun	masa	1
banjir_masa	banjir	masa	1
banyak_masa	banyak	masa	1
banyak_masa-lah	banyak	masa-lah	1
bapakmu_masa	bapakmu	masa	1
baratu_masa	baratu	masa	1
baru_masa	baru	masa	1
batasan_masa	batasan	masa	1
beban_masa	beban	masa	1
beberapa_masa-lah	beberapa	masa-lah	1
belajar_masa	belajar	masa	1
belakang_masa	belakang	masa	1
belakangan_masa	belakangan	masa	1
belenggu_masa	belenggu	masa	1
beliau_masa	beliau	masa	1
benar-benar_masa	benar-benar	masa	1
beranggapan_masa	beranggapan	masa	1
berbicara_masa	berbicara	masa	1
bercerita_masa	bercerita	masa	1
berdimensi_masa	berdimensi	masa	1
beres_masa	beres	masa	1
bergantung_masa	bergantung	masa	1
berharganya_masa	berharganya	masa	1
berjalan_masa	berjalan	masa	1
berkembang_masa	berkembang	masa	1
berkilah_masa	berkilah	masa	1
berkomentar_masa	berkomentar	masa	1
berkumpul_masa	berkumpul	masa	1
berpihak_masa	berpihak	masa	1
berprinsip_masa	berprinsip	masa	1
bersama_masa	bersama	masa	1
bersama-masa_masa	bersama-masa	masa	1
bertahun-tahun_masa	bertahun-tahun	masa	1
bertanya_masa	bertanya	masa	1
besok_masa	besok	masa	1
betul_masa	betul	masa	1
betul_masa-masa	betul	masa-masa	1
biang_masa-lahnya	biang	masa-lahnya	1
bias_masa	bias	masa	1
bisnis_masa	bisnis	masa	1
bomber_masa	bomber	masa	1
bu-lan_masa	bu-lan	masa	1
buat_masa	buat	masa	1
buka_masa	buka	masa	1
bus_masa	bus	masa	1
busana_masa	busana	masa	1
cam-paign_masa	cam-paign	masa	1
cantik_masa	cantik	masa	1
catatan_masa	catatan	masa	1
ce-dera_masa	ce-dera	masa	1
cepat_masa	cepat	masa	1
cheese_masa	cheese	masa	1
cinta_masa	cinta	masa	1
control_masa	control	masa	1
cuaca_masa	cuaca	masa	1
cuma_masa-lah	cuma	masa-lah	1
curiga_masa	curiga	masa	1
da-lam_masa-masa	da-lam	masa-masa	1
daerah_masa	daerah	masa	1
dahulu_masa	dahulu	masa	1
dakwah_masa	dakwah	masa	1
dan_masa-lah	dan	masa-lah	1
dan_masa-masanya	dan	masa-masanya	1
dana_masa	dana	masa	1
dasawarsa_masa	dasawarsa	masa	1
datangnya_masa	datangnya	masa	1
de-pan_masa	de-pan	masa	1
deadline_masa	deadline	masa	1
dekade_masa	dekade	masa	1
demikian_masa-lah	demikian	masa-lah	1
dendam_masa	dendam	masa	1
depan_masa-lah	depan	masa-lah	1
desa_masa	desa	masa	1
desain_masa	desain	masa	1
detik-detik_masa	detik-detik	masa	1
di_masa-lah	di	masa-lah	1
di-potong_masa	di-potong	masa	1
dia_masa-masa	dia	masa-masa	1
diamandemen_masa	diamandemen	masa	1
dibahas_masa	dibahas	masa	1
dibandingkan_masa-masa	dibandingkan	masa-masa	1
dibayang-bayangi_masa	dibayang-bayangi	masa	1
diber-lakukannya_masa	diber-lakukannya	masa	1
dibiarkan_masa-lah	dibiarkan	masa-lah	1
dibobol_masa	dibobol	masa	1
didalam_masa	didalam	masa	1
diduduki_masa	diduduki	masa	1
digital_masa	digital	masa	1
dihadang_masa	dihadang	masa	1
dihadapan_masa	dihadapan	masa	1
dihakimi_masa	dihakimi	masa	1
dihantui_masa	dihantui	masa	1
dihasilkan_masa	dihasilkan	masa	1
diikuti_masa	diikuti	masa	1
dikem-bangkan_masa	dikem-bangkan	masa	1
dilakukan_masa	dilakukan	masa	1
dilihat_masa-lah	dilihat	masa-lah	1
dimainkan_masa	dimainkan	masa	1
dimasukkan_masa	dimasukkan	masa	1
dimulainya_masa-masa	dimulainya	masa-masa	1
dinamakan_masa	dinamakan	masa	1
diper-panjang_masa	diper-panjang	masa	1
diperbaiki_masa	diperbaiki	masa	1
diperhitungkan_masa	diperhitungkan	masa	1
diperpan-jang_masa	diperpan-jang	masa	1
diperpanjang_masa	diperpanjang	masa	1
dipotong-kan_masa	dipotong-kan	masa	1
dirusak_masa	dirusak	masa	1
disebutkan_masa	disebutkan	masa	1
disetujui_masa-lah	disetujui	masa-lah	1
disiapkan_masa	disiapkan	masa	1
disikat_masa	disikat	masa	1
disini_masa	disini	masa	1
disitulah_masa	disitulah	masa	1
ditemukan_masa	ditemukan	masa	1
ditengah_masa	ditengah	masa	1
ditengah-tengah_masa	ditengah-tengah	masa	1
diter-tibkan_masa	diter-tibkan	masa	1
diterapkan_masa	diterapkan	masa	1
ditutupnya_masa	ditutupnya	masa	1
donatur_masa	donatur	masa	1
dosa-dosa_masa	dosa-dosa	masa	1
dua_masa-lah	dua	masa-lah	1
duapertiga_masa	duapertiga	masa	1
dulu_masa	dulu	masa	1
dulu_masa-lah	dulu	masa-lah	1
dunia_masa	dunia	masa	1
durasi_masa	durasi	masa	1
eh_masa	eh	masa	1
ekklesiologi_masa	ekklesiologi	masa	1
ekonomi_masa	ekonomi	masa	1
energy_masa	energy	masa	1
enggak_masa	enggak	masa	1
etis_masa	etis	masa	1
faktor_masa	faktor	masa	1
fokus_masa	fokus	masa	1
formatur_masa	formatur	masa	1
foto-foto_masa	foto-foto	masa	1
fotonya_masa	fotonya	masa	1
gantung_masa	gantung	masa	1
gara-gara_masa-lah	gara-gara	masa-lah	1
gereja-ge-reja_masa	gereja-ge-reja	masa	1
gitu_masa	gitu	masa	1
globalisasi_masa	globalisasi	masa	1
gubernur_masa	gubernur	masa	1
guna_masa	guna	masa	1
guru_masa	guru	masa	1
hadang_masa	hadang	masa	1
hadirnya_masa	hadirnya	masa	1
hakim_masa	hakim	masa	1
hal_masa	hal	masa	1
hancurlah_masa	hancurlah	masa	1
hangat_masa	hangat	masa	1
hearing_masa-lah	hearing	masa-lah	1
heroik_masa	heroik	masa	1
hiburan_masa	hiburan	masa	1
hidup_masa	hidup	masa	1
hilang_masa	hilang	masa	1
hilang_masa-masa	hilang	masa-masa	1
hilangnya_masa	hilangnya	masa	1
hubungan_masa	hubungan	masa	1
hukuman_masa	hukuman	masa	1
ibadah_masa	ibadah	masa	1
identifikasi_masa-lah	identifikasi	masa-lah	1
ilegal_masa	ilegal	masa	1
ilmu_masa	ilmu	masa	1
impian-impian_masa	impian-impian	masa	1
impor_masa	impor	masa	1
indah_masa	indah	masa	1
indah-nya_masa	indah-nya	masa	1
indahnya_masa	indahnya	masa	1
indeks_masa	indeks	masa	1
informasi_masa	informasi	masa	1
ini_masa-lah	ini	masa-lah	1
inkubasi_masa	inkubasi	masa	1
isu_masa	isu	masa	1
itu_masa-masa	itu	masa-masa	1
itulah_masa	itulah	masa	1
jadi_masa-lah	jadi	masa-lah	1
jadwal_masa	jadwal	masa	1
jagad_masa	jagad	masa	1
jalani-lah_masa	jalani-lah	masa	1
jalannya_masa	jalannya	masa	1
jam_masa	jam	masa	1
jamaah_masa	jamaah	masa	1
jamak_masa	jamak	masa	1
jangan_masa	jangan	masa	1
janji_masa	janji	masa	1
jantung_masa	jantung	masa	1
jelang_masa	jelang	masa	1
jenderal_masa	jenderal	masa	1
jumlah_masa	jumlah	masa	1
junior_masa	junior	masa	1
ka-rena_masa	ka-rena	masa	1
kabar_masa	kabar	masa	1
kabinet_masa	kabinet	masa	1
kala_masa	kala	masa	1
kali_masa-masa	kali	masa-masa	1
kampanye_masa	kampanye	masa	1
kanak-kanak_masa	kanak-kanak	masa	1
kandang_masa	kandang	masa	1
karena_masa-lahnya	karena	masa-lahnya	1
karma_masa	karma	masa	1
ke-lebihan_masa	ke-lebihan	masa	1
ke-nanglah_masa	ke-nanglah	masa	1
keadaan_masa	keadaan	masa	1
kebanggaan_masa	kebanggaan	masa	1
kebangsaan_masa	kebangsaan	masa	1
keberangkatan_masa	keberangkatan	masa	1
kebiasaan_masa	kebiasaan	masa	1
kebijakan_masa	kebijakan	masa	1
kebudayaan_masa	kebudayaan	masa	1
kecanggihan_masa	kecanggihan	masa	1
kecantikan_masa	kecantikan	masa	1
kecil_masa	kecil	masa	1
kedelapan_masa	kedelapan	masa	1
kegamangan_masa	kegamangan	masa	1
kegembiraan_masa	kegembiraan	masa	1
kegiatan_masa	kegiatan	masa	1
kegiatan-kegiatan_masa	kegiatan-kegiatan	masa	1
kehormatan_masa	kehormatan	masa	1
keinginan_masa	keinginan	masa	1
kejahatan_masa	kejahatan	masa	1
kejanggalan_masa	kejanggalan	masa	1
kejutan_masa	kejutan	masa	1
kekasih_masa	kekasih	masa	1
kekeliruan_masa	kekeliruan	masa	1
kelima_masa	kelima	masa	1
keluarga_masa	keluarga	masa	1
kemajuan_masa	kemajuan	masa	1
kemegahan_masa	kemegahan	masa	1
kemerdekaan_masa	kemerdekaan	masa	1
kenang-kenangan_masa	kenang-kenangan	masa	1
kenangan_masa-masa	kenangan	masa-masa	1
kendaraan_masa	kendaraan	masa	1
kendati_masa	kendati	masa	1
kenyataan_masa	kenyataan	masa	1
kepala_masa	kepala	masa	1
kepangkatan_masa	kepangkatan	masa	1
kepemerintahan_masa	kepemerintahan	masa	1
ker-ja_masa	ker-ja	masa	1
kerangka_masa	kerangka	masa	1
kerepotan_masa	kerepotan	masa	1
kerja_masa	kerja	masa	1
kesadaran_masa	kesadaran	masa	1
kesalahan-kesalahan_masa	kesalahan-kesalahan	masa	1
kesan-kesan_masa	kesan-kesan	masa	1
kesehatan_masa	kesehatan	masa	1
kesejarahan_masa	kesejarahan	masa	1
keselamatan_masa	keselamatan	masa	1
keseluruhan_masa	keseluruhan	masa	1
kesepakatan_masa	kesepakatan	masa	1
kesuksesan_masa	kesuksesan	masa	1
ketaatan_masa-lah	ketaatan	masa-lah	1
ketemu_masa-masa	ketemu	masa-masa	1
ketentuan_masa	ketentuan	masa	1
keterbatasan_masa	keterbatasan	masa	1
ketika_masa-masa	ketika	masa-masa	1
keuangan_masa	keuangan	masa	1
khas_masa	khas	masa	1
khawatir_masa	khawatir	masa	1
kinerja_masa	kinerja	masa	1
kini_masa	kini	masa	1
kisah_masa	kisah	masa	1
kita_masa	kita	masa	1
kolom_masa	kolom	masa	1
komang_masa	komang	masa	1
kompetisi_masa	kompetisi	masa	1
komunikasi_masa	komunikasi	masa	1
konflik_masa	konflik	masa	1
konsentrasi_masa	konsentrasi	masa	1
konsep_masa	konsep	masa	1
kontras_masa-kan	kontras	masa-kan	1
kontro-versial_masa	kontro-versial	masa	1
koor-dinasi_masa	koor-dinasi	masa	1
korbankan_masa	korbankan	masa	1
kritis_masa	kritis	masa	1
kuat_masa	kuat	masa	1
kuburan_masa	kuburan	masa	1
lagi_masa-masa	lagi	masa-masa	1
lainnya_masa	lainnya	masa	1
lainnya_masa-lah	lainnya	masa-lah	1
langit-langit_masa	langit-langit	masa	1
lanjut-nya_masa	lanjut-nya	masa	1
lanjutnya_masa-lah	lanjutnya	masa-lah	1
le-wat_masa	le-wat	masa	1
lebih_masa	lebih	masa	1
lebih-lebih_masa	lebih-lebih	masa	1
lemahnya_masa	lemahnya	masa	1
lepas_masa	lepas	masa	1
level_masa	level	masa	1
lewati_masa	lewati	masa	1
libur_masa	libur	masa	1
lihat_masa	lihat	masa	1
lima_masa	lima	masa	1
lingkungan_masa	lingkungan	masa	1
lintas_masa	lintas	masa	1
listrik_masa	listrik	masa	1
luar_masa	luar	masa	1
lusa_masa	lusa	masa	1
maa_masa	maa	masa	1
macet_masa	macet	masa	1
mahal_masa	mahal	masa	1
makan_masa	makan	masa	1
makna_masa	makna	masa	1
maksimal_masa	maksimal	masa	1
malah_masa-lah	malah	masa-lah	1
martabat_masa	martabat	masa	1
masa_1800-an	masa	1800-an	1
masa_1920-an	masa	1920-an	1
masa_1930-an	masa	1930-an	1
masa_1960-an	masa	1960-an	1
masa_1980-an	masa	1980-an	1
masa_60-an	masa	60-an	1
masa_80-90an	masa	80-90an	1
masa_abad	masa	abad	1
masa_advent	masa	advent	1
masa_adventus	masa	adventus	1
masa_akhirnya	masa	akhirnya	1
masa_akreditasi	masa	akreditasi	1
masa_aku	masa	aku	1
masa_akun	masa	akun	1
masa_amnesti	masa	amnesti	1
masa_anak	masa	anak	1
masa_anak-anaknya	masa	anak-anaknya	1
masa_asimilasi	masa	asimilasi	1
masa_asuransi	masa	asuransi	1
masa_awal-awal	masa	awal-awal	1
masa_awalnya	masa	awalnya	1
masa_babak	masa	babak	1
masa_bagi	masa	bagi	1
masa_bahan	masa	bahan	1
masa_balita	masa	balita	1
masa_balitanya	masa	balitanya	1
masa_bangunan	masa	bangunan	1
masa_baru	masa	baru	1
masa_bebas	masa	bebas	1
masa_bekerja	masa	bekerja	1
masa_belajarnya	masa	belajarnya	1
masa_belia	masa	belia	1
masa_bencana	masa	bencana	1
masa_ber-laku	masa	ber-laku	1
masa_ber-lakunya	masa	ber-lakunya	1
masa_berahinya	masa	berahinya	1
masa_berbagai	masa	berbagai	1
masa_berduka	masa	berduka	1
masa_bergeloranya	masa	bergeloranya	1
masa_berjuang	masa	berjuang	1
masa_berkembangnya	masa	berkembangnya	1
masa_berkuasa	masa	berkuasa	1
masa_berkunjung	masa	berkunjung	1
masa_berlaku-nya	masa	berlaku-nya	1
masa_berlangganan	masa	berlangganan	1
masa_berpacaran	masa	berpacaran	1
masa_bertarung	masa	bertarung	1
masa_besar	masa	besar	1
masa_bisa	masa	bisa	1
masa_buah	masa	buah	1
masa_bukan	masa	bukan	1
masa_bukannya	masa	bukannya	1
masa_bunga	masa	bunga	1
masa_buruh	masa	buruh	1
masa_bus	masa	bus	1
masa_cabang	masa	cabang	1
masa_cenderung	masa	cenderung	1
masa_cicilan	masa	cicilan	1
masa_cobaan	masa	cobaan	1
masa_cuaca	masa	cuaca	1
masa_cutinya	masa	cutinya	1
masa_dana	masa	dana	1
masa_dapa	masa	dapa	1
masa_data	masa	data	1
masa_de-pannya	masa	de-pannya	1
masa_deadline	masa	deadline	1
masa_demo	masa	demo	1
masa_denial	masa	denial	1
masa_depan-nya	masa	depan-nya	1
masa_derby	masa	derby	1
masa_diagnosa	masa	diagnosa	1
masa_diam	masa	diam	1
masa_dibeda-beda	masa	dibeda-beda	1
masa_dibuka	masa	dibuka	1
masa_dihebohkan	masa	dihebohkan	1
masa_dikeroyok	masa	dikeroyok	1
masa_dilakukan	masa	dilakukan	1
masa_dimentokin	masa	dimentokin	1
masa_dinasti	masa	dinasti	1
masa_diper-kirakan	masa	diper-kirakan	1
masa_disampaikan	masa	disampaikan	1
masa_diseluruh	masa	diseluruh	1
masa_distribusi	masa	distribusi	1
masa_dita-ngani	masa	dita-ngani	1
masa_ditemukannya	masa	ditemukannya	1
masa_ditinggal	masa	ditinggal	1
masa_ditolak	masa	ditolak	1
masa_doa	masa	doa	1
masa_donasi	masa	donasi	1
masa_dorang	masa	dorang	1
masa_efektif	masa	efektif	1
masa_eksploitasi	masa	eksploitasi	1
masa_eksplorasi	masa	eksplorasi	1
masa_elus	masa	elus	1
masa_emiritus	masa	emiritus	1
masa_fanatik	masa	fanatik	1
masa_fasilitas	masa	fasilitas	1
masa_fermentasinya	masa	fermentasinya	1
masa_festival	masa	festival	1
masa_frustasi	masa	frustasi	1
masa_fung-sional	masa	fung-sional	1
masa_galau	masa	galau	1
masa_gencatan	masa	gencatan	1
masa_gerobak	masa	gerobak	1
masa_giling	masa	giling	1
masa_globalisasi	masa	globalisasi	1
masa_gubernur	masa	gubernur	1
masa_haji	masa	haji	1
masa_hanya	masa	hanya	1
masa_hidup-nya	masa	hidup-nya	1
masa_hu-kuman	masa	hu-kuman	1
masa_huku-man	masa	huku-man	1
masa_huku-mannya	masa	huku-mannya	1
masa_idah	masa	idah	1
masa_in-jury	masa	in-jury	1
masa_in-kubasi	masa	in-kubasi	1
masa_inagurasi	masa	inagurasi	1
masa_industrialisasi	masa	industrialisasi	1
masa_inilah	masa	inilah	1
masa_integrasi	masa	integrasi	1
masa_internasionalisasi	masa	internasionalisasi	1
masa_iPhone	masa	iPhone	1
masa_izinnya	masa	izinnya	1
masa_jab	masa	jab	1
masa_jaba-tan	masa	jaba-tan	1
masa_jabat-an	masa	jabat-an	1
masa_jabatan-nya	masa	jabatan-nya	1
masa_jadi	masa	jadi	1
masa_jadwal	masa	jadwal	1
masa_jahiliyah	masa	jahiliyah	1
masa_jam	masa	jam	1
masa_jandanya	masa	jandanya	1
masa_jang	masa	jang	1
masa_jangka	masa	jangka	1
masa_janin	masa	janin	1
masa_jatuhnya	masa	jatuhnya	1
masa_jedah	masa	jedah	1
masa_jelang	masa	jelang	1
masa_jendela	masa	jendela	1
masa_juga	masa	juga	1
masa_jumlah	masa	jumlah	1
masa_ka-rantina	masa	ka-rantina	1
masa_kada-luarsa	masa	kada-luarsa	1
masa_kadaluarsa	masa	kadaluarsa	1
masa_kadaluwarsanya	masa	kadaluwarsanya	1
masa_kam-panye	masa	kam-panye	1
masa_kami	masa	kami	1
masa_kampanya	masa	kampanya	1
masa_kampanye-nya	masa	kampanye-nya	1
masa_kampaye	masa	kampaye	1
masa_kampenye	masa	kampenye	1
masa_kamu	masa	kamu	1
masa_kanaknya	masa	kanaknya	1
masa_katanya	masa	katanya	1
masa_kawinnya	masa	kawinnya	1
masa_ke-cilnya	masa	ke-cilnya	1
masa_ke-merdekaan	masa	ke-merdekaan	1
masa_keberangkatan	masa	keberangkatan	1
masa_keberlakuan	masa	keberlakuan	1
masa_kecilku	masa	kecilku	1
masa_kecurigaan	masa	kecurigaan	1
masa_kedaluarsa	masa	kedaluarsa	1
masa_kedaulatan	masa	kedaulatan	1
masa_kedudukan	masa	kedudukan	1
masa_kehamil-an	masa	kehamil-an	1
masa_kehidupannya	masa	kehidupannya	1
masa_kehilangan	masa	kehilangan	1
masa_kejadiannya	masa	kejadiannya	1
masa_kekaisaran	masa	kekaisaran	1
masa_kekosongan	masa	kekosongan	1
masa_kekuasaannya	masa	kekuasaannya	1
masa_kelahiran	masa	kelahiran	1
masa_kelas	masa	kelas	1
masa_kemasukan	masa	kemasukan	1
masa_kematian	masa	kematian	1
masa_kemunculannya	masa	kemunculannya	1
masa_kenabian	masa	kenabian	1
masa_kepada	masa	kepada	1
masa_kepala	masa	kepala	1
masa_kepe-mimpinannya	masa	kepe-mimpinannya	1
masa_kepeimpinannya	masa	kepeimpinannya	1
masa_kepemim-pinan	masa	kepemim-pinan	1
masa_kepemimpi-nan	masa	kepemimpi-nan	1
masa_kepenguru-san	masa	kepenguru-san	1
masa_kepresidenannya	masa	kepresidenannya	1
masa_kerajaannya	masa	kerajaannya	1
masa_kering	masa	kering	1
masa_kesadarannya	masa	kesadarannya	1
masa_kesendiriannya	masa	kesendiriannya	1
masa_keseng-saraan	masa	keseng-saraan	1
masa_kesuburannya	masa	kesuburannya	1
masa_kesusahan	masa	kesusahan	1
masa_ketagihan	masa	ketagihan	1
masa_khalifah	masa	khalifah	1
masa_klarifikasi	masa	klarifikasi	1
masa_klasik	masa	klasik	1
masa_klub	masa	klub	1
masa_ko-ass	masa	ko-ass	1
masa_kodifikasi	masa	kodifikasi	1
masa_kompetisi	masa	kompetisi	1
masa_kong	masa	kong	1
masa_kontemporer	masa	kontemporer	1
masa_kontrak-nya	masa	kontrak-nya	1
masa_kri-sis	masa	kri-sis	1
masa_kuliahnya	masa	kuliahnya	1
masa_kunjungan	masa	kunjungan	1
masa_kurang	masa	kurang	1
masa_kurungan	masa	kurungan	1
masa_kwa	masa	kwa	1
masa_lajang8	masa	lajang8	1
masa_lajangSelasa	masa	lajangSelasa	1
masa_lampaunya	masa	lampaunya	1
masa_latihan	masa	latihan	1
masa_ley	masa	ley	1
masa_li-buran	masa	li-buran	1
masa_libu-rannya	masa	libu-rannya	1
masa_liburn	masa	liburn	1
masa_limit	masa	limit	1
masa_long	masa	long	1
masa_lowong	masa	lowong	1
masa_mahasiswa	masa	mahasiswa	1
masa_maju	masa	maju	1
masa_masa	masa	masa	1
masa_masih	masa	masih	1
masa_masing-masing	masa	masing-masing	1
masa_masuk	masa	masuk	1
masa_masukan	masa	masukan	1
masa_memanggilnya	masa	memanggilnya	1
masa_membubarkan	masa	membubarkan	1
masa_memenangkan	masa	memenangkan	1
masa_memiliki	masa	memiliki	1
masa_memperjuangkan	masa	memperjuangkan	1
masa_mempersiapkan	masa	mempersiapkan	1
masa_menabung	masa	menabung	1
masa_menanam	masa	menanam	1
masa_mengambang	masa	mengambang	1
masa_menghiasi	masa	menghiasi	1
masa_mengkhawatirkan	masa	mengkhawatirkan	1
masa_menopouse	masa	menopouse	1
masa_menunggu	masa	menunggu	1
masa_menunjukkan	masa	menunjukkan	1
masa_menyongsong	masa	menyongsong	1
masa_mereka	masa	mereka	1
masa_meributkan	masa	meributkan	1
masa_merupakan	masa	merupakan	1
masa_mewarnai	masa	mewarnai	1
masa_milik	masa	milik	1
masa_mo-dernisasi	masa	mo-dernisasi	1
masa_mualaf	masa	mualaf	1
masa_mudaku	masa	mudaku	1
masa_mudamu	masa	mudamu	1
masa_mulai	masa	mulai	1
masa_mungkin	masa	mungkin	1
masa_musti	masa	musti	1
masa_nama-nama	masa	nama-nama	1
masa_nginapnya	masa	nginapnya	1
masa_nolak	masa	nolak	1
masa_operasionalisasi	masa	operasionalisasi	1
masa_otot	masa	otot	1
masa_out-break	masa	out-break	1
masa_ovulasi	masa	ovulasi	1
masa_pa-nen	masa	pa-nen	1
masa_pagi-pagi	masa	pagi-pagi	1
masa_panennya	masa	panennya	1
masa_partai-partai	masa	partai-partai	1
masa_pasca-Orde	masa	pasca-Orde	1
masa_pasca-proklamasi	masa	pasca-proklamasi	1
masa_pasca-Soeharto	masa	pasca-Soeharto	1
masa_pe-meliharaan	masa	pe-meliharaan	1
masa_pekan	masa	pekan	1
masa_pelati-han	masa	pelati-han	1
masa_pema-sukan	masa	pema-sukan	1
masa_pemantapan	masa	pemantapan	1
masa_pembahasan	masa	pembahasan	1
masa_pembantaran	masa	pembantaran	1
masa_pembayarannya	masa	pembayarannya	1
masa_pembekuan	masa	pembekuan	1
masa_pemberian	masa	pemberian	1
masa_pemberlakuan	masa	pemberlakuan	1
masa_pemberontakan	masa	pemberontakan	1
masa_pembibitan	masa	pembibitan	1
masa_pembinaan	masa	pembinaan	1
masa_pembuangan	masa	pembuangan	1
masa_pembuatan	masa	pembuatan	1
masa_peme	masa	peme	1
masa_pemeimpinan	masa	pemeimpinan	1
masa_pemeriksaan	masa	pemeriksaan	1
masa_pemerin-tahan	masa	pemerin-tahan	1
masa_pemilihannya	masa	pemilihannya	1
masa_pemilukada	masa	pemilukada	1
masa_pemkab	masa	pemkab	1
masa_pemungutan	masa	pemungutan	1
masa_pemusatan	masa	pemusatan	1
masa_pemutakhiran	masa	pemutakhiran	1
masa_pen-siunnya	masa	pen-siunnya	1
masa_pena-hanannya	masa	pena-hanannya	1
masa_penaha-nannya	masa	penaha-nannya	1
masa_penahannya	masa	penahannya	1
masa_penaklukan	masa	penaklukan	1
masa_penangguhan	masa	penangguhan	1
masa_penangkapannya	masa	penangkapannya	1
masa_penaya-ngan	masa	penaya-ngan	1
masa_penayangan	masa	penayangan	1
masa_penayangannya	masa	penayangannya	1
masa_pencalo-nan	masa	pencalo-nan	1
masa_penciptaannya	masa	penciptaannya	1
masa_pencocokan	masa	pencocokan	1
masa_pendemo	masa	pendemo	1
masa_penebusan	masa	penebusan	1
masa_penegak	masa	penegak	1
masa_penelitian	masa	penelitian	1
masa_penetapan	masa	penetapan	1
masa_peng-abdian	masa	peng-abdian	1
masa_pengamanan	masa	pengamanan	1
masa_pengampunan	masa	pengampunan	1
masa_pengasingan	masa	pengasingan	1
masa_pengelolaannya	masa	pengelolaannya	1
masa_penggarapan	masa	penggarapan	1
masa_penghentian	masa	penghentian	1
masa_penghujan	masa	penghujan	1
masa_pengiriman	masa	pengiriman	1
masa_pengolahan	masa	pengolahan	1
masa_pengukuran	masa	pengukuran	1
masa_penilaian	masa	penilaian	1
masa_penindasan	masa	penindasan	1
masa_peningkatan	masa	peningkatan	1
masa_penjajah-an	masa	penjajah-an	1
masa_penjajahannya	masa	penjajahannya	1
masa_penjatahan	masa	penjatahan	1
masa_pensi-un	masa	pensi-un	1
masa_pensiunan	masa	pensiunan	1
masa_penududkan	masa	penududkan	1
masa_penugasannya	masa	penugasannya	1
masa_penumpukan	masa	penumpukan	1
masa_penundaan	masa	penundaan	1
masa_penurunan	masa	penurunan	1
masa_penyaluran	masa	penyaluran	1
masa_penyanderaan	masa	penyanderaan	1
masa_penyegelan	masa	penyegelan	1
masa_penyelesaian	masa	penyelesaian	1
masa_penyusunan	masa	penyusunan	1
masa_per-cobaan	masa	per-cobaan	1
masa_per-panjangan	masa	per-panjangan	1
masa_perampungan	masa	perampungan	1
masa_peraturan	masa	peraturan	1
masa_perawatannya	masa	perawatannya	1
masa_perceraian	masa	perceraian	1
masa_percobaannya	masa	percobaannya	1
masa_perekaman	masa	perekaman	1
masa_peremajaan	masa	peremajaan	1
masa_periodenya	masa	periodenya	1
masa_periodesasi	masa	periodesasi	1
masa_periodisasi	masa	periodisasi	1
masa_perjalanan	masa	perjalanan	1
masa_perjanjian	masa	perjanjian	1
masa_perkabungan	masa	perkabungan	1
masa_perke-nalan	masa	perke-nalan	1
masa_perkembangan	masa	perkembangan	1
masa_perkuliahan	masa	perkuliahan	1
masa_perluasan	masa	perluasan	1
masa_permulaan	masa	permulaan	1
masa_perpan-jangan	masa	perpan-jangan	1
masa_perpanjanga	masa	perpanjanga	1
masa_perpindahan	masa	perpindahan	1
masa_perrayaan	masa	perrayaan	1
masa_persaingan	masa	persaingan	1
masa_perselisihan	masa	perselisihan	1
masa_persennya	masa	persennya	1
masa_pertanaman	masa	pertanaman	1
masa_pidana	masa	pidana	1
masa_pidananya	masa	pidananya	1
masa_pilcaleg	masa	pilcaleg	1
masa_pilihan	masa	pilihan	1
masa_pilpres	masa	pilpres	1
masa_pinjam	masa	pinjam	1
masa_planet	masa	planet	1
masa_populasi	masa	populasi	1
masa_post	masa	post	1
masa_pra-industrialisasi	masa	pra-industrialisasi	1
masa_pra-moderen	masa	pra-moderen	1
masa_pra-Paskah	masa	pra-Paskah	1
masa_pramusim	masa	pramusim	1
masa_prapenempatan	masa	prapenempatan	1
masa_praperadilan	masa	praperadilan	1
masa_prasekolah	masa	prasekolah	1
masa_primitif	masa	primitif	1
masa_produk	masa	produk	1
masa_produktivitas	masa	produktivitas	1
masa_proses	masa	proses	1
masa_puber	masa	puber	1
masa_pungkasnya	masa	pungkasnya	1
masa_punya	masa	punya	1
masa_pur-nabakti	masa	pur-nabakti	1
masa_raja-raja	masa	raja-raja	1
masa_rakyat	masa	rakyat	1
masa_re-ses	masa	re-ses	1
masa_real	masa	real	1
masa_recoverinya	masa	recoverinya	1
masa_refreshing	masa	refreshing	1
masa_rehabilitasi	masa	rehabilitasi	1
masa_ren-tan	masa	ren-tan	1
masa_renovasi	masa	renovasi	1
masa_rentan	masa	rentan	1
masa_rezim	masa	rezim	1
masa_ribuan	masa	ribuan	1
masa_riset	masa	riset	1
masa_rumah	masa	rumah	1
masa_sakit	masa	sakit	1
masa_sama	masa	sama	1
masa_sampai	masa	sampai	1
masa_sang-gah	masa	sang-gah	1
masa_sang-sara	masa	sang-sara	1
masa_sangat	masa	sangat	1
masa_sanggahan	masa	sanggahan	1
masa_satgas	masa	satgas	1
masa_se-karang	masa	se-karang	1
masa_sebe-lumnya	masa	sebe-lumnya	1
masa_secara	masa	secara	1
masa_sejarah	masa	sejarah	1
masa_seka	masa	seka	1
masa_sekitar	masa	sekitar	1
masa_selama	masa	selama	1
masa_semua	masa	semua	1
masa_senggang	masa	senggang	1
masa_sensitif	masa	sensitif	1
masa_sepeninggal	masa	sepeninggal	1
masa_sepuluh	masa	sepuluh	1
masa_seraya	masa	seraya	1
masa_sesudah	masa	sesudah	1
masa_sesudahnya	masa	sesudahnya	1
masa_setahun	masa	setahun	1
masa_si-dang	masa	si-dang	1
masa_simpatisan	masa	simpatisan	1
masa_sisa	masa	sisa	1
masa_situasi	masa	situasi	1
masa_skandal	masa	skandal	1
masa_skors	masa	skors	1
masa_skorsing	masa	skorsing	1
masa_somo	masa	somo	1
masa_sopir	masa	sopir	1
masa_sosialisasinya	masa	sosialisasinya	1
masa_status	masa	status	1
masa_suara	masa	suara	1
masa_subsider	masa	subsider	1
masa_subuh-subuh	masa	subuh-subuh	1
masa_suku	masa	suku	1
masa_sungguh	masa	sungguh	1
masa_suratnya	masa	suratnya	1
masa_taha-nan	masa	taha-nan	1
masa_tahan-an	masa	tahan-an	1
masa_tahananya	masa	tahananya	1
masa_tak	masa	tak	1
masa_tambahnya	masa	tambahnya	1
masa_tamsilnya	masa	tamsilnya	1
masa_tan-dasnya	masa	tan-dasnya	1
masa_tanggal	masa	tanggal	1
masa_tarif	masa	tarif	1
masa_tempo	masa	tempo	1
masa_tenor	masa	tenor	1
masa_terabaik	masa	terabaik	1
masa_terakhir	masa	terakhir	1
masa_terbang	masa	terbang	1
masa_terberat	masa	terberat	1
masa_terpotong-potong	masa	terpotong-potong	1
masa_terse-but	masa	terse-but	1
masa_tertentu	masa	tertentu	1
masa_tertinggi	masa	tertinggi	1
masa_tes	masa	tes	1
masa_tiap	masa	tiap	1
masa_tiap-tiap	masa	tiap-tiap	1
masa_tibanya	masa	tibanya	1
masa_tindak	masa	tindak	1
masa_toddler	masa	toddler	1
masa_tolerans	masa	tolerans	1
masa_torang	masa	torang	1
masa_transi	masa	transi	1
masa_treatment	masa	treatment	1
masa_tryout	masa	tryout	1
masa_tubuh	masa	tubuh	1
masa_tulis	masa	tulis	1
masa_tumbuhnya	masa	tumbuhnya	1
masa_tunggunya	masa	tunggunya	1
masa_turut	masa	turut	1
masa_tutup	masa	tutup	1
masa_udara	masa	udara	1
masa_ujar	masa	ujar	1
masa_ujicoba	masa	ujicoba	1
masa_ujung	masa	ujung	1
masa_ulang	masa	ulang	1
masa_umur	masa	umur	1
masa_umurnya	masa	umurnya	1
masa_ungkap	masa	ungkap	1
masa_ungkapnya	masa	ungkapnya	1
masa_unjury	masa	unjury	1
masa_usai	masa	usai	1
masa_utama	masa	utama	1
masa_vote	masa	vote	1
masa_waktunya	masa	waktunya	1
masa_website	masa	website	1
masa_yanng	masa	yanng	1
masa-kan_gara-gara	masa-kan	gara-gara	1
masa-lah_administrasi	masa-lah	administrasi	1
masa-lah_administratif	masa-lah	administratif	1
masa-lah_ampas	masa-lah	ampas	1
masa-lah_aspirasi	masa-lah	aspirasi	1
masa-lah_atau	masa-lah	atau	1
masa-lah_biasa	masa-lah	biasa	1
masa-lah_daging	masa-lah	daging	1
masa-lah_eceng	masa-lah	eceng	1
masa-lah_ekologi	masa-lah	ekologi	1
masa-lah_fasilitas	masa-lah	fasilitas	1
masa-lah_galian	masa-lah	galian	1
masa-lah_ganti	masa-lah	ganti	1
masa-lah_gelar	masa-lah	gelar	1
masa-lah_hotel	masa-lah	hotel	1
masa-lah_hukum	masa-lah	hukum	1
masa-lah_ijazah	masa-lah	ijazah	1
masa-lah_izin	masa-lah	izin	1
masa-lah_jadi	masa-lah	jadi	1
masa-lah_karyawan	masa-lah	karyawan	1
masa-lah_kata	masa-lah	kata	1
masa-lah_keamanan	masa-lah	keamanan	1
masa-lah_kemapanan	masa-lah	kemapanan	1
masa-lah_kemiskinan	masa-lah	kemiskinan	1
masa-lah_kemitraan	masa-lah	kemitraan	1
masa-lah_kendaraan	masa-lah	kendaraan	1
masa-lah_kepengurusan	masa-lah	kepengurusan	1
masa-lah_kesehatan	masa-lah	kesehatan	1
masa-lah_keuangan	masa-lah	keuangan	1
masa-lah_keuangannya	masa-lah	keuangannya	1
masa-lah_kewarganegaraan	masa-lah	kewarganegaraan	1
masa-lah_konflik	masa-lah	konflik	1
masa-lah_korupsi	masa-lah	korupsi	1
masa-lah_krisis	masa-lah	krisis	1
masa-lah_krusial	masa-lah	krusial	1
masa-lah_lagi	masa-lah	lagi	1
masa-lah_lain	masa-lah	lain	1
masa-lah_lingkungan	masa-lah	lingkungan	1
masa-lah_operasional	masa-lah	operasional	1
masa-lah_pangan	masa-lah	pangan	1
masa-lah_pendaftaran	masa-lah	pendaftaran	1
masa-lah_pengangkatan	masa-lah	pengangkatan	1
masa-lah_pengisian	masa-lah	pengisian	1
masa-lah_peperangan	masa-lah	peperangan	1
masa-lah_perayaan	masa-lah	perayaan	1
masa-lah_perizinan	masa-lah	perizinan	1
masa-lah_pertambangan	masa-lah	pertambangan	1
masa-lah_pilkada	masa-lah	pilkada	1
masa-lah_politik	masa-lah	politik	1
masa-lah_pribadi	masa-lah	pribadi	1
masa-lah_pungutan	masa-lah	pungutan	1
masa-lah_rektor	masa-lah	rektor	1
masa-lah_retribusi	masa-lah	retribusi	1
masa-lah_rumah	masa-lah	rumah	1
masa-lah_sebab	masa-lah	sebab	1
masa-lah_selama	masa-lah	selama	1
masa-lah_selera	masa-lah	selera	1
masa-lah_serius	masa-lah	serius	1
masa-lah_tarif	masa-lah	tarif	1
masa-lah_tenaga	masa-lah	tenaga	1
masa-lah_tender	masa-lah	tender	1
masa-lah_terminal	masa-lah	terminal	1
masa-lah_transnational	masa-lah	transnational	1
masa-lah_tukasnya	masa-lah	tukasnya	1
masa-lah_utama	masa-lah	utama	1
masa-lah_utang	masa-lah	utang	1
masa-lah_waktu	masa-lah	waktu	1
masa-lah-masalah_dasar	masa-lah-masalah	dasar	1
masa-lah-masalah_perindustrian	masa-lah-masalah	perindustrian	1
masa-lah-masalah_sosial	masa-lah-masalah	sosial	1
masa-lah-masalah_yang	masa-lah-masalah	yang	1
masa-lahnya_akan	masa-lahnya	akan	1
masa-lahnya_belanja	masa-lahnya	belanja	1
masa-lahnya_bukan	masa-lahnya	bukan	1
masa-lahnya_di	masa-lahnya	di	1
masa-lahnya_dipublikasikan	masa-lahnya	dipublikasikan	1
masa-lahnya_hanya	masa-lahnya	hanya	1
masa-lahnya_hanyalah	masa-lahnya	hanyalah	1
masa-lahnya_hingga	masa-lahnya	hingga	1
masa-lahnya_menjadi	masa-lahnya	menjadi	1
masa-lahnya_sudah	masa-lahnya	sudah	1
masa-ma-sa_ter-akhir	masa-ma-sa	ter-akhir	1
masa-masa_adaptasi	masa-masa	adaptasi	1
masa-masa_akhir	masa-masa	akhir	1
masa-masa_anaknya	masa-masa	anaknya	1
masa-masa_awalnya	masa-masa	awalnya	1
masa-masa_baik	masa-masa	baik	1
masa-masa_berat	masa-masa	berat	1
masa-masa_berdua	masa-masa	berdua	1
masa-masa_berikutnya	masa-masa	berikutnya	1
masa-masa_berlainan	masa-masa	berlainan	1
masa-masa_diakonal	masa-masa	diakonal	1
masa-masa_ekonomi	masa-masa	ekonomi	1
masa-masa_emas	masa-masa	emas	1
masa-masa_gelap	masa-masa	gelap	1
masa-masa_genting	masa-masa	genting	1
masa-masa_indah	masa-masa	indah	1
masa-masa_inkubasi	masa-masa	inkubasi	1
masa-masa_itulah	masa-masa	itulah	1
masa-masa_jaya	masa-masa	jaya	1
masa-masa_ke-depan	masa-masa	ke-depan	1
masa-masa_kecilnya	masa-masa	kecilnya	1
masa-masa_kepanikan	masa-masa	kepanikan	1
masa-masa_kepemimpi-nan	masa-masa	kepemimpi-nan	1
masa-masa_ketika	masa-masa	ketika	1
masa-masa_kita	masa-masa	kita	1
masa-masa_krusial	masa-masa	krusial	1
masa-masa_libur	masa-masa	libur	1
masa-masa_men-datang	masa-masa	men-datang	1
masa-masa_mendatar	masa-masa	mendatar	1
masa-masa_menjelang	masa-masa	menjelang	1
masa-masa_muda	masa-masa	muda	1
masa-masa_nakal	masa-masa	nakal	1
masa-masa_orde	masa-masa	orde	1
masa-masa_paceklik	masa-masa	paceklik	1
masa-masa_pe-nantian	masa-masa	pe-nantian	1
masa-masa_pembahasan	masa-masa	pembahasan	1
masa-masa_pemilihan	masa-masa	pemilihan	1
masa-masa_penan-tian	masa-masa	penan-tian	1
masa-masa_penantian	masa-masa	penantian	1
masa-masa_penelitian	masa-masa	penelitian	1
masa-masa_penghujung	masa-masa	penghujung	1
masa-masa_penyembuhan	masa-masa	penyembuhan	1
masa-masa_percobaan	masa-masa	percobaan	1
masa-masa_perjuangan	masa-masa	perjuangan	1
masa-masa_persiapan	masa-masa	persiapan	1
masa-masa_persidangan	masa-masa	persidangan	1
masa-masa_pertamanya	masa-masa	pertamanya	1
masa-masa_pesta	masa-masa	pesta	1
masa-masa_praindustri	masa-masa	praindustri	1
masa-masa_s	masa-masa	s	1
masa-masa_sebelum	masa-masa	sebelum	1
masa-masa_sekarang	masa-masa	sekarang	1
masa-masa_selanjutnya	masa-masa	selanjutnya	1
masa-masa_sesudah	masa-masa	sesudah	1
masa-masa_sidang	masa-masa	sidang	1
masa-masa_strategis	masa-masa	strategis	1
masa-masa_sulitnya	masa-masa	sulitnya	1
masa-masa_tahapan	masa-masa	tahapan	1
masa-masa_terberat	masa-masa	terberat	1
masa-masa_terpenting	masa-masa	terpenting	1
masa-masa_transisi	masa-masa	transisi	1
masa-masanya_di	masa-masanya	di	1
masa-nya_di	masa-nya	di	1
masa-nya_yang	masa-nya	yang	1
massa_masa-kini	massa	masa-kini	1
masuk_masa-masa	masuk	masa-masa	1
masuki_masa	masuki	masa	1
mata_masa	mata	masa	1
mau_masa	mau	masa	1
maupun_masa-masa	maupun	masa-masa	1
me-dia_masa	me-dia	masa	1
me-lepaskan_masa	me-lepaskan	masa	1
me-lewati_masa	me-lewati	masa	1
me-lewati_masa-masa	me-lewati	masa-masa	1
me-manfaaatkan_masa	me-manfaaatkan	masa	1
me-manfaatkan_masa	me-manfaatkan	masa	1
me-mang_masa	me-mang	masa	1
me-mentingkan_masa	me-mentingkan	masa	1
me-ngalami_masa	me-ngalami	masa	1
me-ngenang_masa-masa	me-ngenang	masa-masa	1
me-ngingat_masa	me-ngingat	masa	1
me-ngisi_masa	me-ngisi	masa	1
mela-kukan_masa	mela-kukan	masa	1
melalui_masa-masa	melalui	masa-masa	1
melaporkan_masa	melaporkan	masa	1
mele-wati_masa	mele-wati	masa	1
melepaskan_masa	melepaskan	masa	1
melewatkan_masa	melewatkan	masa	1
melindungi_masa	melindungi	masa	1
meluruskan_masa-lah	meluruskan	masa-lah	1
memaksimalkan_masa	memaksimalkan	masa	1
memang_masa-lahnya	memang	masa-lahnya	1
memasuki_masa-masa	memasuki	masa-masa	1
membahas_masa-lah-masalah	membahas	masa-lah-masalah	1
membatasi_masa	membatasi	masa	1
membawa_masa-masa	membawa	masa-masa	1
membentuk_masa	membentuk	masa	1
memberi_masa	memberi	masa	1
membicarakan_masa-lah	membicarakan	masa-lah	1
mememperpanjang_masa	mememperpanjang	masa	1
memengaruhi_masa	memengaruhi	masa	1
mementingkan_masa	mementingkan	masa	1
memerangi_masa-lah	memerangi	masa-lah	1
memerhatikan_masa	memerhatikan	masa	1
memerlukan_masa	memerlukan	masa	1
memerpanjang_masa	memerpanjang	masa	1
memiiliki_masa	memiiliki	masa	1
memilih_masa	memilih	masa	1
meminta_masa	meminta	masa	1
memoar_masa	memoar	masa	1
mempelajari_masa-lah	mempelajari	masa-lah	1
mempengaruhi_masa	mempengaruhi	masa	1
memper-masalahkan_masa	memper-masalahkan	masa	1
memper-panjang_masa	memper-panjang	masa	1
memper-pendek_masa	memper-pendek	masa	1
memperanjang_masa	memperanjang	masa	1
memperhatikan_masa	memperhatikan	masa	1
memperhatikan_masa-lah	memperhatikan	masa-lah	1
memperkirakan_masa	memperkirakan	masa	1
memperluas_masa	memperluas	masa	1
memperuncing_masa-lah	memperuncing	masa-lah	1
memprotek_masa	memprotek	masa	1
memundurkan_masa	memundurkan	masa	1
men-ceritakan_masa	men-ceritakan	masa	1
men-galami_masa-masa	men-galami	masa-masa	1
men-jalani_masa	men-jalani	masa	1
menahan_masa	menahan	masa	1
menangani_masa-lah	menangani	masa-lah	1
menanggani_masa-lah	menanggani	masa-lah	1
menanggulangi_masa-lah	menanggulangi	masa-lah	1
menanyakan_masa	menanyakan	masa	1
menapaki_masa	menapaki	masa	1
mencari_masa-lah	mencari	masa-lah	1
mencermati_masa-lah	mencermati	masa-lah	1
mencukupi_masa	mencukupi	masa	1
mendalami_masa	mendalami	masa	1
mendapat_masa	mendapat	masa	1
mendapatkan_masa	mendapatkan	masa	1
mendekapi_masa	mendekapi	masa	1
mendialogkan_masa	mendialogkan	masa	1
mendiskusikan_masa	mendiskusikan	masa	1
menduduki_masa	menduduki	masa	1
mene-gaskan_masa	mene-gaskan	masa	1
meneken_masa	meneken	masa	1
menelusuri_masa	menelusuri	masa	1
menemani_masa	menemani	masa	1
menempuh_masa	menempuh	masa	1
menemui_masa-masa	menemui	masa-masa	1
menemukan_masa	menemukan	masa	1
menemukan_masa-lah	menemukan	masa-lah	1
menen-tukan_masa	menen-tukan	masa	1
menerapkan_masa	menerapkan	masa	1
menerima_masa	menerima	masa	1
menerima_masa-masa	menerima	masa-masa	1
meng-alami_masa	meng-alami	masa	1
meng-gadaikan_masa	meng-gadaikan	masa	1
meng-gilas_masa	meng-gilas	masa	1
meng-hormati_masa-masa	meng-hormati	masa-masa	1
mengabaikan_masa-lah	mengabaikan	masa-lah	1
mengakomodasi_masa-lah	mengakomodasi	masa-lah	1
mengaku_masa	mengaku	masa	1
mengaku_masa-masa	mengaku	masa-masa	1
mengamanatkan_masa	mengamanatkan	masa	1
mengambil_masa	mengambil	masa	1
mengancurkan_masa	mengancurkan	masa	1
mengatasi_masa-lah-masalah	mengatasi	masa-lah-masalah	1
mengatur_masa	mengatur	masa	1
mengekspos_masa-lah	mengekspos	masa-lah	1
mengelola_masa	mengelola	masa	1
mengenang_masa-masa	mengenang	masa-masa	1
mengerahkan_masa	mengerahkan	masa	1
mengerti_masa	mengerti	masa	1
mengetahui_masa-masa	mengetahui	masa-masa	1
mengevaluasi_masa	mengevaluasi	masa	1
menggalang_masa	menggalang	masa	1
menggambarkan_masa	menggambarkan	masa	1
menghabisi_masa	menghabisi	masa	1
menghabiskan_masa-masa	menghabiskan	masa-masa	1
menghabiskan_masa-nya	menghabiskan	masa-nya	1
menghadapi_masa-masa	menghadapi	masa-masa	1
menghalangi_masa	menghalangi	masa	1
menghasilkan_masa	menghasilkan	masa	1
menghilangkan_masa	menghilangkan	masa	1
menghomati_masa	menghomati	masa	1
menghormati_masa	menghormati	masa	1
mengikuti_masa	mengikuti	masa	1
mengingatkan_masa	mengingatkan	masa	1
mengisahkan_masa-lah	mengisahkan	masa-lah	1
mengiyakan_masa	mengiyakan	masa	1
mengukir_masa	mengukir	masa	1
mengulang_masa	mengulang	masa	1
mengulangi_masa	mengulangi	masa	1
mengumpulkan_masa	mengumpulkan	masa	1
mengungkapkan_masa-lah-masalah	mengungkapkan	masa-lah-masalah	1
mengungkit_masa	mengungkit	masa	1
mengurangi_masa	mengurangi	masa	1
mengurus_masa-lah	mengurus	masa-lah	1
mengurusi_masa-lah	mengurusi	masa-lah	1
menik-mati_masa	menik-mati	masa	1
menimbulkan_masa-lah	menimbulkan	masa-lah	1
menindaklanjuti_masa-lah	menindaklanjuti	masa-lah	1
meninggalkan_masa	meninggalkan	masa	1
meniti_masa	meniti	masa	1
menjadi_masa-lahnya	menjadi	masa-lahnya	1
menjadi_masa-masa	menjadi	masa-masa	1
menjalani_masa-masa	menjalani	masa-masa	1
menjangkau_masa	menjangkau	masa	1
menjawab_masa	menjawab	masa	1
menjelang_masa-ma-sa	menjelang	masa-ma-sa	1
menjelang_masa-masa	menjelang	masa-masa	1
menjembatani_masa	menjembatani	masa	1
menjumpai_masa	menjumpai	masa	1
menumpuk_masa	menumpuk	masa	1
menunggangi_masa	menunggangi	masa	1
menunjang_masa	menunjang	masa	1
menunjukkan_masa	menunjukkan	masa	1
menuntaskan_masa	menuntaskan	masa	1
menurutku_masa	menurutku	masa	1
menurutnya_masa	menurutnya	masa	1
menyalah-gunakan_masa	menyalah-gunakan	masa	1
menyambung_masa	menyambung	masa	1
menyampaikan_masa	menyampaikan	masa	1
menyandarkan_masa	menyandarkan	masa	1
menyangka_masa	menyangka	masa	1
menyebut_masa	menyebut	masa	1
menyebut-nyebut_masa	menyebut-nyebut	masa	1
menyebutkan_masa	menyebutkan	masa	1
menyelami_masa	menyelami	masa	1
menyentuh_masa	menyentuh	masa	1
menyesalkan_masa	menyesalkan	masa	1
menyimpulkan_masa	menyimpulkan	masa	1
menyongsong_masa-masa	menyongsong	masa-masa	1
menyoroti_masa	menyoroti	masa	1
menyuarakan_masa	menyuarakan	masa	1
menyuarakan_masa-lah	menyuarakan	masa-lah	1
menyudahi_masa	menyudahi	masa	1
menyulitkan_masa	menyulitkan	masa	1
menyuramkan_masa	menyuramkan	masa	1
meracuni_masa	meracuni	masa	1
merajut_masa	merajut	masa	1
merampungkan_masa	merampungkan	masa	1
merampungkan_masa-lah	merampungkan	masa-lah	1
merangkai_masa	merangkai	masa	1
mereka_masa-masa	mereka	masa-masa	1
merekalah_masa	merekalah	masa	1
merencana-kan_masa	merencana-kan	masa	1
merencanakan_masa	merencanakan	masa	1
mereplay_masa	mereplay	masa	1
merepresentasikan_masa	merepresentasikan	masa	1
merindukan_masa-masa	merindukan	masa-masa	1
merintis_masa	merintis	masa	1
merokok_masa	merokok	masa	1
meru-pakan_masa	meru-pakan	masa	1
meru-sak_masa	meru-sak	masa	1
merubah_masa	merubah	masa	1
merugikan_masa	merugikan	masa	1
merupa-kan_masa	merupa-kan	masa	1
meskipun_masa	meskipun	masa	1
mestinya_masa	mestinya	masa	1
mewarnai_masa-masa	mewarnai	masa-masa	1
mikir_masa	mikir	masa	1
miliar_masa	miliar	masa	1
mindset_masa	mindset	masa	1
minimal_masa	minimal	masa	1
mmebuat_masa	mmebuat	masa	1
mobilisasi_masa	mobilisasi	masa	1
mobilitas_masa	mobilitas	masa	1
mobility_masa	mobility	masa	1
mode_masa	mode	masa	1
momen_masa	momen	masa	1
moral_masa	moral	masa	1
mpls_masa	mpls	masa	1
mula_masa	mula	masa	1
mundur_masa	mundur	masa	1
musim_masa	musim	masa	1
muslim_masa	muslim	masa	1
nada_masa	nada	masa	1
nanti_masa	nanti	masa	1
narkoba_masa	narkoba	masa	1
nasib_masa	nasib	masa	1
nelayan_masa	nelayan	masa	1
netralisir_masa	netralisir	masa	1
niiih_masa	niiih	masa	1
noh_masa	noh	masa	1
nostalgia_masa	nostalgia	masa	1
nostalgia_masa-masa	nostalgia	masa-masa	1
oknum_masa	oknum	masa	1
optimis_masa	optimis	masa	1
optimisme_masa	optimisme	masa	1
optimistis_masa	optimistis	masa	1
orang-orang_masa	orang-orang	masa	1
orangtua_masa	orangtua	masa	1
organisasi_masa	organisasi	masa	1
otomatis_masa	otomatis	masa	1
pa-da_masa-masa	pa-da	masa-masa	1
pacemaker_masa	pacemaker	masa	1
padi_masa	padi	masa	1
pakta_masa	pakta	masa	1
pangan_masa	pangan	masa	1
pari-wisata_masa	pari-wisata	masa	1
pariwisata_masa	pariwisata	masa	1
partai_masa	partai	masa	1
pasa_masa	pasa	masa	1
pasal_masa	pasal	masa	1
pasar_masa	pasar	masa	1
pasti_masa	pasti	masa	1
pe-manggul_masa	pe-manggul	masa	1
pe-rempuan-perempuan_masa	pe-rempuan-perempuan	masa	1
pedih_masa	pedih	masa	1
pegawai_masa	pegawai	masa	1
pekerjaan_masa	pekerjaan	masa	1
pelajar_masa	pelajar	masa	1
pelajaran-pelajaran_masa	pelajaran-pelajaran	masa	1
pelanggaran_masa	pelanggaran	masa	1
pelayanan_masa	pelayanan	masa	1
pem-batasan_masa	pem-batasan	masa	1
pemain_masa	pemain	masa	1
pemasaran_masa	pemasaran	masa	1
pembangungan_masa	pembangungan	masa	1
pembentukan_masa	pembentukan	masa	1
pemberitahuan_masa	pemberitahuan	masa	1
pemerintah_masa	pemerintah	masa	1
pemerintahan_masa	pemerintahan	masa	1
pemikir-pemikir_masa	pemikir-pemikir	masa	1
pemikiran_masa	pemikiran	masa	1
pemimpinan_masa	pemimpinan	masa	1
pemodelan_masa	pemodelan	masa	1
pemotongan_masa	pemotongan	masa	1
pemuda_masa	pemuda	masa	1
penanganan_masa-lah	penanganan	masa-lah	1
pendidikan_masa	pendidikan	masa	1
penelitian_masa	penelitian	masa	1
penerapan_masa	penerapan	masa	1
penetapan_masa	penetapan	masa	1
pengakhiran_masa	pengakhiran	masa	1
pengantin_masa	pengantin	masa	1
pengemban_masa	pengemban	masa	1
penggalangan_masa	penggalangan	masa	1
penghentian_masa	penghentian	masa	1
penghujung_masa	penghujung	masa	1
pengu-rangan_masa	pengu-rangan	masa	1
pengulangan_masa	pengulangan	masa	1
pengumpulan_masa	pengumpulan	masa	1
pengurus_masa	pengurus	masa	1
pengusaha_masa	pengusaha	masa	1
peningkatan_masa	peningkatan	masa	1
penjajah_masa	penjajah	masa	1
penjara_masa	penjara	masa	1
penyelesaian_masa-lah	penyelesaian	masa-lah	1
per-soalan_masa	per-soalan	masa	1
perekonomian_masa	perekonomian	masa	1
perencanaan_masa	perencanaan	masa	1
perhatian_masa	perhatian	masa	1
perhatikan_masa	perhatikan	masa	1
perhitungan_masa	perhitungan	masa	1
perjuangan_masa	perjuangan	masa	1
perkembangan_masa	perkembangan	masa	1
persaingan_masa	persaingan	masa	1
persen_masa-lah	persen	masa-lah	1
persoalan_masa	persoalan	masa	1
persoalan-persoalan_masa	persoalan-persoalan	masa	1
perspektif_masa	perspektif	masa	1
persyaratan_masa	persyaratan	masa	1
pertandingan_masa	pertandingan	masa	1
pertaruhan_masa	pertaruhan	masa	1
pertaruhkan_masa	pertaruhkan	masa	1
pertengahan_masa	pertengahan	masa	1
pertunjukan_masa	pertunjukan	masa	1
pesawat_masa	pesawat	masa	1
pesepakbola_masa	pesepakbola	masa	1
peta_masa	peta	masa	1
petualangan_masa	petualangan	masa	1
pidana_masa	pidana	masa	1
pilcarek_masa	pilcarek	masa	1
pilihan_masa	pilihan	masa	1
pililihan_masa	pililihan	masa	1
pilkada_masa	pilkada	masa	1
po-tongan_masa	po-tongan	masa	1
pola_masa	pola	masa	1
politisi_masa	politisi	masa	1
pondasi_masa	pondasi	masa	1
potensi_masa	potensi	masa	1
prapenempatan_masa	prapenempatan	masa	1
prestasi_masa	prestasi	masa	1
propinsi_masa	propinsi	masa	1
proses_masa	proses	masa	1
prospek_masa	prospek	masa	1
protestan_masa	protestan	masa	1
proyeksi_masa	proyeksi	masa	1
pulau_masa	pulau	masa	1
pulihnya_masa	pulihnya	masa	1
purnama_masa	purnama	masa	1
putaran_masa	putaran	masa	1
rangkaian_masa	rangkaian	masa	1
rapur_masa	rapur	masa	1
raya_masa	raya	masa	1
realitas_masa	realitas	masa	1
referendum_masa	referendum	masa	1
rekor_masa	rekor	masa	1
rektor_masa	rektor	masa	1
rentang_masa	rentang	masa	1
revolusi_masa	revolusi	masa	1
rezim_masa	rezim	masa	1
ribu-an_masa	ribu-an	masa	1
riil_masa	riil	masa	1
rokok_masa	rokok	masa	1
ruang_masa	ruang	masa	1
sadiki-sadiki_masa	sadiki-sadiki	masa	1
saja_masa-lah	saja	masa-lah	1
saksi_masa-masa	saksi	masa-masa	1
sama_masa	sama	masa	1
sampah_masa	sampah	masa	1
sampi_masa	sampi	masa	1
sangka_masa	sangka	masa	1
sasaran_masa	sasaran	masa	1
satu_masa-masa	satu	masa-masa	1
saya_masa-lah	saya	masa-lah	1
se-bagai_masa	se-bagai	masa	1
se-belum_masa	se-belum	masa	1
se-jak_masa	se-jak	masa	1
seakan-akan_masa	seakan-akan	masa	1
sebagaimana_masa	sebagaimana	masa	1
sebagian_masa	sebagian	masa	1
sebuah_masa-lah	sebuah	masa-lah	1
sebut-sebut_masa	sebut-sebut	masa	1
secara_masa	secara	masa	1
segudang_masa-lah	segudang	masa-lah	1
sehari_masa	sehari	masa	1
seharusnya_masa-lah	seharusnya	masa-lah	1
seindah_masa-masa	seindah	masa-masa	1
seiring_masa	seiring	masa	1
seja-rah_masa	seja-rah	masa	1
sejak_masa-masa	sejak	masa-masa	1
sejarah-sejarah_masa	sejarah-sejarah	masa	1
sejatinya_masa	sejatinya	masa	1
sejumlah_masa	sejumlah	masa	1
sekelompok_masa	sekelompok	masa	1
sekiranya_masa-lah	sekiranya	masa-lah	1
sekolah_masa	sekolah	masa	1
sela_masa	sela	masa	1
seleksi_masa	seleksi	masa	1
selesainya_masa	selesainya	masa	1
selidiki_masa-lah	selidiki	masa-lah	1
semangat_masa	semangat	masa	1
semboyan_masa	semboyan	masa	1
sementara_masa	sementara	masa	1
semeriah_masa	semeriah	masa	1
semua_masa	semua	masa	1
seni_masa	seni	masa	1
sense_masa	sense	masa	1
sepan-jang_masa	sepan-jang	masa	1
sepanjang_masa-masa	sepanjang	masa-masa	1
sependapat_masa-masa	sependapat	masa-masa	1
serahkan_masa-lah	serahkan	masa-lah	1
serentak_masa	serentak	masa	1
seseringÂ­_masa	seseringÂ­	masa	1
sesudah_masa	sesudah	masa	1
sesungguhnya_masa	sesungguhnya	masa	1
setalah_masa	setalah	masa	1
seterang_masa	seterang	masa	1
setuju_masa	setuju	masa	1
si_masa	si	masa	1
sia-siakan_masa	sia-siakan	masa	1
sikap_masa	sikap	masa	1
siklus_masa	siklus	masa	1
simbol_masa	simbol	masa	1
skali_masa	skali	masa	1
skuat_masa	skuat	masa	1
smartphone_masa	smartphone	masa	1
so_masa-masa	so	masa-masa	1
soal_masa-lah	soal	masa-lah	1
soal_masa-masa	soal	masa-masa	1
songsong_masa	songsong	masa	1
spirit_masa	spirit	masa	1
status_masa	status	masa	1
strategi_masa	strategi	masa	1
striker_masa	striker	masa	1
suai_masa	suai	masa	1
suci_masa	suci	masa	1
sukses_masa	sukses	masa	1
supaya_masa	supaya	masa	1
supaya_masa-lah	supaya	masa-lah	1
superstar_masa	superstar	masa	1
suplemen_masa	suplemen	masa	1
ta-hun_masa	ta-hun	masa	1
tambang_masa	tambang	masa	1
tampaknya_masa	tampaknya	masa	1
tanah_masa	tanah	masa	1
tanggal_masa	tanggal	masa	1
tangkis_masa	tangkis	masa	1
taruhan_masa	taruhan	masa	1
tawanan_masa	tawanan	masa	1
tegaskan_masa	tegaskan	masa	1
teka-teki_masa	teka-teki	masa	1
tekanan_masa	tekanan	masa	1
tekstil_masa	tekstil	masa	1
teleskop_masa	teleskop	masa	1
tembikar_masa	tembikar	masa	1
tembusan_masa	tembusan	masa	1
ten-tang_masa	ten-tang	masa	1
tentang_masa-lah-masalah	tentang	masa-lah-masalah	1
tentang_masa-masa	tentang	masa-masa	1
tentara_masa	tentara	masa	1
tentunya_masa-masa	tentunya	masa-masa	1
ter-tular_masa	ter-tular	masa	1
terangi_masa	terangi	masa	1
terbatasnya_masa	terbatasnya	masa	1
terdapat_masa-lah	terdapat	masa-lah	1
tergantung_masa	tergantung	masa	1
terha-dap_masa	terha-dap	masa	1
terhadap_masa-lah	terhadap	masa-lah	1
terhalang_masa-lah	terhalang	masa-lah	1
terhangat_masa	terhangat	masa	1
terima_masa	terima	masa	1
terjadi_masa	terjadi	masa	1
terjadi_masa-lah	terjadi	masa-lah	1
terjamin_masa	terjamin	masa	1
terkenalnya_masa	terkenalnya	masa	1
terlaris_masa	terlaris	masa	1
terlibat_masa-lah	terlibat	masa-lah	1
ternak_masa	ternak	masa	1
ternama_masa	ternama	masa	1
terorisme_masa	terorisme	masa	1
terpidana_masa	terpidana	masa	1
terpilih_masa	terpilih	masa	1
tersebut_masa	tersebut	masa	1
tertentu_masa-lah	tertentu	masa-lah	1
terus_masa	terus	masa	1
terwujudnya_masa	terwujudnya	masa	1
tetapi_masa-lah	tetapi	masa-lah	1
tiap_masa	tiap	masa	1
tidak_masa	tidak	masa	1
tidak_masa-lah	tidak	masa-lah	1
tidaklah_masa	tidaklah	masa	1
tinggal_masa	tinggal	masa	1
tinggi_masa	tinggi	masa	1
tombak_masa	tombak	masa	1
tontonan_masa	tontonan	masa	1
tradisional_masa	tradisional	masa	1
transportasi_masa	transportasi	masa	1
trend_masa	trend	masa	1
truk_masa	truk	masa	1
tua_masa	tua	masa	1
tubuhku_masa	tubuhku	masa	1
tugas_masa	tugas	masa	1
tumpuan_masa	tumpuan	masa	1
tuntutan_masa	tuntutan	masa	1
ujarnya_masa	ujarnya	masa	1
umat_masa	umat	masa	1
unggul_masa	unggul	masa	1
untuk_masa-masa	untuk	masa-masa	1
urban_masa	urban	masa	1
urutan_masa	urutan	masa	1
usaha_masa	usaha	masa	1
usainya_masa	usainya	masa	1
usulan_masa	usulan	masa	1
wabup_masa	wabup	masa	1
waktu_masa-masa	waktu	masa-masa	1
waktu-waktu_masa	waktu-waktu	masa	1
walikota_masa	walikota	masa	1
warisan_masa	warisan	masa	1
wartawan_masa	wartawan	masa	1
wujudkanlah_masa	wujudkanlah	masa	1
yaitu_masa	yaitu	masa	1
yak-ni_masa	yak-ni	masa	1
yakin_masa	yakin	masa	1
yakini_masa	yakini	masa	1
