ngram	w1	w2	n
dalam_waktu	dalam	waktu	2237
waktu_lalu	waktu	lalu	2027
beberapa_waktu	beberapa	waktu	1769
waktu_dekat	waktu	dekat	1575
waktu_yang	waktu	yang	1446
waktu_itu	waktu	itu	805
waktu_setempat	waktu	setempat	548
waktu_untuk	waktu	untuk	519
pada_waktu	pada	waktu	397
membutuhkan_waktu	membutuhkan	waktu	326
batas_waktu	batas	waktu	310
kurun_waktu	kurun	waktu	302
memakan_waktu	memakan	waktu	300
waktu_dan	waktu	dan	297
butuh_waktu	butuh	waktu	279
pukul_waktu	pukul	waktu	271
tepat_waktu	tepat	waktu	261
dengan_waktu	dengan	waktu	257
jangka_waktu	jangka	waktu	245
waktu_lama	waktu	lama	215
menghabiskan_waktu	menghabiskan	waktu	204
dan_waktu	dan	waktu	200
waktu_dua	waktu	dua	194
waktu_menit	waktu	menit	187
catatan_waktu	catatan	waktu	179
waktu_satu	waktu	satu	164
waktu_tiga	waktu	tiga	156
waktu_sekitar	waktu	sekitar	150
dari_waktu	dari	waktu	147
ada_waktu	ada	waktu	138
waktu_tahun	waktu	tahun	136
sementara_waktu	sementara	waktu	135
waktu_di	waktu	di	130
waktu_ke	waktu	ke	130
di_waktu	di	waktu	123
punya_waktu	punya	waktu	123
waktu_singkat	waktu	singkat	121
menunggu_waktu	menunggu	waktu	119
waktu_hari	waktu	hari	116
waktu_hingga	waktu	hingga	114
banyak_waktu	banyak	waktu	112
ke_waktu	ke	waktu	110
memerlukan_waktu	memerlukan	waktu	107
memiliki_waktu	memiliki	waktu	103
malam_waktu	malam	waktu	101
waktu_jam	waktu	jam	95
rentang_waktu	rentang	waktu	92
sisa_waktu	sisa	waktu	92
perlu_waktu	perlu	waktu	88
berjalannya_waktu	berjalannya	waktu	87
waktu_lebih	waktu	lebih	81
waktu_pelaksanaan	waktu	pelaksanaan	81
memberikan_waktu	memberikan	waktu	76
waktu_kurang	waktu	kurang	76
waktu_lima	waktu	lima	75
waktu_selama	waktu	selama	75
waktu_dengan	waktu	dengan	74
waktu_detik	waktu	detik	74
waktu_terakhir	waktu	terakhir	74
waktu_tersebut	waktu	tersebut	71
meluangkan_waktu	meluangkan	waktu	70
perpanjangan_waktu	perpanjangan	waktu	67
waktu_luang	waktu	luang	66
waktu_tertentu	waktu	tertentu	61
waktu_beberapa	waktu	beberapa	60
waktu_saya	waktu	saya	59
tenggat_waktu	tenggat	waktu	58
waktu_cukup	waktu	cukup	56
karena_waktu	karena	waktu	55
bebe-rapa_waktu	bebe-rapa	waktu	54
da-lam_waktu	da-lam	waktu	53
waktu_empat	waktu	empat	52
adalah_waktu	adalah	waktu	51
memanfaatkan_waktu	memanfaatkan	waktu	50
untuk_waktu	untuk	waktu	50
waktu_sampai	waktu	sampai	50
be-berapa_waktu	be-berapa	waktu	49
yang_waktu	yang	waktu	49
waktu_normal	waktu	normal	48
dibutuhkan_waktu	dibutuhkan	waktu	47
waktu_enam	waktu	enam	46
diberi_waktu	diberi	waktu	45
mengisi_waktu	mengisi	waktu	45
waktu_bagi	waktu	bagi	45
waktu_bulan	waktu	bulan	45
waktu_tercepat	waktu	tercepat	45
waktu_tempuh	waktu	tempuh	44
pagi_waktu	pagi	waktu	43
waktu_istirahat	waktu	istirahat	43
setiap_waktu	setiap	waktu	42
waktu_bersama	waktu	bersama	42
waktu_masih	waktu	masih	41
waktu_tidak	waktu	tidak	41
waktu_dalam	waktu	dalam	40
waktu_panjang	waktu	panjang	40
sepanjang_waktu	sepanjang	waktu	39
waktu_terbaik	waktu	terbaik	38
waktu_antara	waktu	antara	37
waktu_karena	waktu	karena	37
diberikan_waktu	diberikan	waktu	36
waktu_bersamaan	waktu	bersamaan	36
waktu_kepada	waktu	kepada	36
hingga_waktu	hingga	waktu	35
merupakan_waktu	merupakan	waktu	35
waktu_belakangan	waktu	belakangan	34
waktu_de-kat	waktu	de-kat	34
waktu_paling	waktu	paling	34
soal_waktu	soal	waktu	33
lima_waktu	lima	waktu	32
meminta_waktu	meminta	waktu	32
sebelum_waktu	sebelum	waktu	32
waktu_kata	waktu	kata	32
masalah_waktu	masalah	waktu	31
saya_waktu	saya	waktu	31
waktu_ini	waktu	ini	31
waktu_lagi	waktu	lagi	31
waktu_saja	waktu	saja	31
waktu_tujuh	waktu	tujuh	31
waktu_libur	waktu	libur	30
cukup_waktu	cukup	waktu	28
membagi_waktu	membagi	waktu	28
tambahan_waktu	tambahan	waktu	28
bom_waktu	bom	waktu	27
mencatatkan_waktu	mencatatkan	waktu	27
perjalanan_waktu	perjalanan	waktu	27
waktu_dari	waktu	dari	27
itu_waktu	itu	waktu	26
kapan_waktu	kapan	waktu	26
memberi_waktu	memberi	waktu	26
satu_waktu	satu	waktu	26
suatu_waktu	suatu	waktu	26
tenggang_waktu	tenggang	waktu	26
waktu_atau	waktu	atau	26
mencatat_waktu	mencatat	waktu	25
sedikit_waktu	sedikit	waktu	25
waktu_bermain	waktu	bermain	25
waktu_malam	waktu	malam	25
menghemat_waktu	menghemat	waktu	24
menyita_waktu	menyita	waktu	24
sampai_waktu	sampai	waktu	24
waktu_akan	waktu	akan	24
waktu_mereka	waktu	mereka	24
lain_waktu	lain	waktu	23
minta_waktu	minta	waktu	23
waktu_hanya	waktu	hanya	23
waktu_mendatang	waktu	mendatang	23
waktu_pendaftaran	waktu	pendaftaran	23
waktu_sebulan	waktu	sebulan	23
waktu_tunggu	waktu	tunggu	23
ketepatan_waktu	ketepatan	waktu	22
lama_waktu	lama	waktu	22
menjadi_waktu	menjadi	waktu	22
seiring_waktu	seiring	waktu	22
waktu_kita	waktu	kita	22
waktu_pada	waktu	pada	22
waktu_persiapan	waktu	persiapan	22
waktu_relatif	waktu	relatif	22
waktu_shalat	waktu	shalat	22
waktu_sudah	waktu	sudah	22
waktu_tidur	waktu	tidur	22
batasan_waktu	batasan	waktu	21
ini_waktu	ini	waktu	21
keterbatasan_waktu	keterbatasan	waktu	21
seperti_waktu	seperti	waktu	21
waktu_berbuka	waktu	berbuka	21
waktu_setelah	waktu	setelah	21
mengulur_waktu	mengulur	waktu	20
saat_waktu	saat	waktu	20
sesuai_waktu	sesuai	waktu	20
waktu_agar	waktu	agar	20
waktu_kami	waktu	kami	20
waktu_kerja	waktu	kerja	20
waktu_setahun	waktu	setahun	20
waktu_tak	waktu	tak	20
mengatur_waktu	mengatur	waktu	19
mengulur-ulur_waktu	mengulur-ulur	waktu	19
siang_waktu	siang	waktu	19
waktu_cepat	waktu	cepat	19
waktu_para	waktu	para	19
waktu_sebelumnya	waktu	sebelumnya	19
waktu_silam	waktu	silam	19
durasi_waktu	durasi	waktu	18
mencari_waktu	mencari	waktu	18
saja_waktu	saja	waktu	18
selang_waktu	selang	waktu	18
waktu_belajar	waktu	belajar	18
waktu_berjalan	waktu	berjalan	18
waktu_sebelum	waktu	sebelum	18
antar_waktu	antar	waktu	17
bebera-pa_waktu	bebera-pa	waktu	17
hari_waktu	hari	waktu	17
makan_waktu	makan	waktu	17
paruh_waktu	paruh	waktu	17
selisih_waktu	selisih	waktu	17
waktu_hampir	waktu	hampir	17
waktu_pertandingan	waktu	pertandingan	17
waktu_seminggu	waktu	seminggu	17
waktu_senggang	waktu	senggang	17
waktu_ujar	waktu	ujar	17
atau_waktu	atau	waktu	16
buang_waktu	buang	waktu	16
ketika_waktu	ketika	waktu	16
membuang_waktu	membuang	waktu	16
menikmati_waktu	menikmati	waktu	16
menyediakan_waktu	menyediakan	waktu	16
sore_waktu	sore	waktu	16
waktu_kemudian	waktu	kemudian	16
waktu_makan	waktu	makan	16
waktu_pelaksanaannya	waktu	pelaksanaannya	16
kehilangan_waktu	kehilangan	waktu	15
limit_waktu	limit	waktu	15
maka_waktu	maka	waktu	15
mempunyai_waktu	mempunyai	waktu	15
mengejar_waktu	mengejar	waktu	15
waktu_bisa	waktu	bisa	15
waktu_liburan	waktu	liburan	15
waktu_tersisa	waktu	tersisa	15
waktu_terus	waktu	terus	15
bukan_waktu	bukan	waktu	14
jika_waktu	jika	waktu	14
menggunakan_waktu	menggunakan	waktu	14
mengurangi_waktu	mengurangi	waktu	14
waktu_latihan	waktu	latihan	14
waktu_saat	waktu	saat	14
waktu_sehingga	waktu	sehingga	14
waktu_sepuluh	waktu	sepuluh	14
waktu_setengah	waktu	setengah	14
waktu_tenaga	waktu	tenaga	14
diperlukan_waktu	diperlukan	waktu	13
jeda_waktu	jeda	waktu	13
juga_waktu	juga	waktu	13
kepastian_waktu	kepastian	waktu	13
menempuh_waktu	menempuh	waktu	13
mengatakan_waktu	mengatakan	waktu	13
mengenal_waktu	mengenal	waktu	13
menyempatkan_waktu	menyempatkan	waktu	13
mepetnya_waktu	mepetnya	waktu	13
sehingga_waktu	sehingga	waktu	13
setelah_waktu	setelah	waktu	13
waktu_dia	waktu	dia	13
waktu_khusus	waktu	khusus	13
waktu_maksimal	waktu	maksimal	13
waktu_penyelesaian	waktu	penyelesaian	13
waktu_perjalanan	waktu	perjalanan	13
waktu_salat	waktu	salat	13
waktu_tapi	waktu	tapi	13
waktu_ujarnya	waktu	ujarnya	13
bahwa_waktu	bahwa	waktu	12
memangkas_waktu	memangkas	waktu	12
mengingat_waktu	mengingat	waktu	12
mengorbankan_waktu	mengorbankan	waktu	12
menit_waktu	menit	waktu	12
menjelang_waktu	menjelang	waktu	12
perbedaan_waktu	perbedaan	waktu	12
target_waktu	target	waktu	12
total_waktu	total	waktu	12
waktu_banyak	waktu	banyak	12
waktu_berbulan-bulan	waktu	berbulan-bulan	12
waktu_bertahun-tahun	waktu	bertahun-tahun	12
waktu_juga	waktu	juga	12
waktu_sepekan	waktu	sepekan	12
waktu_serta	waktu	serta	12
deadline_waktu	deadline	waktu	11
dulu_waktu	dulu	waktu	11
efisiensi_waktu	efisiensi	waktu	11
jadi_waktu	jadi	waktu	11
membuang-buang_waktu	membuang-buang	waktu	11
mengenai_waktu	mengenai	waktu	11
tapi_waktu	tapi	waktu	11
terkait_waktu	terkait	waktu	11
tunggu_waktu	tunggu	waktu	11
waktu_ada	waktu	ada	11
waktu_berjam-jam	waktu	berjam-jam	11
waktu_delapan	waktu	delapan	11
waktu_katanya	waktu	katanya	11
waktu_kecil	waktu	kecil	11
waktu_maka	waktu	maka	11
waktu_pemasukan	waktu	pemasukan	11
waktu_penyelenggaraan	waktu	penyelenggaraan	11
waktu_tinggal	waktu	tinggal	11
kami_waktu	kami	waktu	10
korupsi_waktu	korupsi	waktu	10
mana_waktu	mana	waktu	10
masa_waktu	masa	waktu	10
mem-butuhkan_waktu	mem-butuhkan	waktu	10
membu-tuhkan_waktu	membu-tuhkan	waktu	10
membuat_waktu	membuat	waktu	10
menyisakan_waktu	menyisakan	waktu	10
periode_waktu	periode	waktu	10
waktu_ia	waktu	ia	10
waktu_kampanye	waktu	kampanye	10
waktu_keberangkatan	waktu	keberangkatan	10
waktu_kejadian	waktu	kejadian	10
waktu_lawan	waktu	lawan	10
waktu_menjadi	waktu	menjadi	10
waktu_minggu	waktu	minggu	10
waktu_minimal	waktu	minimal	10
waktu_pelantikan	waktu	pelantikan	10
waktu_seperti	waktu	seperti	10
waktu_sesuai	waktu	sesuai	10
waktu_subuh	waktu	subuh	10
waktu_tambahan	waktu	tambahan	10
berikan_waktu	berikan	waktu	9
disiplin_waktu	disiplin	waktu	9
hemat_waktu	hemat	waktu	9
ingat_waktu	ingat	waktu	9
lalu_waktu	lalu	waktu	9
luar_waktu	luar	waktu	9
me-makan_waktu	me-makan	waktu	9
memperpanjang_waktu	memperpanjang	waktu	9
sebagai_waktu	sebagai	waktu	9
tengat_waktu	tengat	waktu	9
waktu_berbeda	waktu	berbeda	9
waktu_namun	waktu	namun	9
waktu_pagi	waktu	pagi	9
waktu_pembayaran	waktu	pembayaran	9
waktu_pemilihan	waktu	pemilihan	9
waktu_penerbangan	waktu	penerbangan	9
waktu_pengerjaan	waktu	pengerjaan	9
waktu_sekejap	waktu	sekejap	9
waktu_semakin	waktu	semakin	9
waktu_sembilan	waktu	sembilan	9
berjangka_waktu	berjangka	waktu	8
gunakan_waktu	gunakan	waktu	8
kalau_waktu	kalau	waktu	8
kerangka_waktu	kerangka	waktu	8
lamanya_waktu	lamanya	waktu	8
memastikan_waktu	memastikan	waktu	8
mempersingkat_waktu	mempersingkat	waktu	8
mengambil_waktu	mengambil	waktu	8
menyiapkan_waktu	menyiapkan	waktu	8
padahal_waktu	padahal	waktu	8
tentang_waktu	tentang	waktu	8
tiba_waktu	tiba	waktu	8
waktu_babak	waktu	babak	8
waktu_kapan	waktu	kapan	8
waktu_membuat	waktu	membuat	8
waktu_menunggu	waktu	menunggu	8
waktu_pemeriksaan	waktu	pemeriksaan	8
waktu_pemulihan	waktu	pemulihan	8
waktu_pengiriman	waktu	pengiriman	8
waktu_pengurusan	waktu	pengurusan	8
waktu_pulang	waktu	pulang	8
waktu_sangat	waktu	sangat	8
waktu_sehari	waktu	sehari	8
waktu_sejenak	waktu	sejenak	8
waktu_tanpa	waktu	tanpa	8
akhir_waktu	akhir	waktu	7
dikejar_waktu	dikejar	waktu	7
inilah_waktu	inilah	waktu	7
kita_waktu	kita	waktu	7
lagi_waktu	lagi	waktu	7
lewat_waktu	lewat	waktu	7
luangkan_waktu	luangkan	waktu	7
maupun_waktu	maupun	waktu	7
me-nunggu_waktu	me-nunggu	waktu	7
membukukan_waktu	membukukan	waktu	7
memilih_waktu	memilih	waktu	7
mempergunakan_waktu	mempergunakan	waktu	7
mendapatkan_waktu	mendapatkan	waktu	7
mendekati_waktu	mendekati	waktu	7
menentukan_waktu	menentukan	waktu	7
menyisihkan_waktu	menyisihkan	waktu	7
meski_waktu	meski	waktu	7
meskipun_waktu	meskipun	waktu	7
oleh_waktu	oleh	waktu	7
selama_waktu	selama	waktu	7
toleransi_waktu	toleransi	waktu	7
waktu_adalah	waktu	adalah	7
waktu_anak	waktu	anak	7
waktu_berdekatan	waktu	berdekatan	7
waktu_bongkar	waktu	bongkar	7
waktu_kalau	waktu	kalau	7
waktu_kedatangan	waktu	kedatangan	7
waktu_luangnya	waktu	luangnya	7
waktu_pencairan	waktu	pencairan	7
waktu_penutupan	waktu	penutupan	7
waktu_penyerahan	waktu	penyerahan	7
waktu_pertama	waktu	pertama	7
waktu_pilkada	waktu	pilkada	7
waktu_sahur	waktu	sahur	7
waktu_sebab	waktu	sebab	7
waktu_secara	waktu	secara	7
waktu_tepat	waktu	tepat	7
buang-buang_waktu	buang-buang	waktu	6
dinihari_waktu	dinihari	waktu	6
jam_waktu	jam	waktu	6
jumlah_waktu	jumlah	waktu	6
kenal_waktu	kenal	waktu	6
kurangnya_waktu	kurangnya	waktu	6
manfaatkan_waktu	manfaatkan	waktu	6
mema-kan_waktu	mema-kan	waktu	6
memasuki_waktu	memasuki	waktu	6
mereka_waktu	mereka	waktu	6
minimnya_waktu	minimnya	waktu	6
sama_waktu	sama	waktu	6
sekali_waktu	sekali	waktu	6
tahun_waktu	tahun	waktu	6
waktu_akhir	waktu	akhir	6
waktu_awal	waktu	awal	6
waktu_belum	waktu	belum	6
waktu_berkumpul	waktu	berkumpul	6
waktu_berlalu	waktu	berlalu	6
waktu_dapat	waktu	dapat	6
waktu_jadi	waktu	jadi	6
waktu_jumlah	waktu	jumlah	6
waktu_lamanya	waktu	lamanya	6
waktu_masa	waktu	masa	6
waktu_menunjukkan	waktu	menunjukkan	6
waktu_pelunasan	waktu	pelunasan	6
waktu_pembahasan	waktu	pembahasan	6
waktu_pengajuan	waktu	pengajuan	6
waktu_pengumuman	waktu	pengumuman	6
waktu_penyaluran	waktu	penyaluran	6
waktu_proses	waktu	proses	6
waktu_sebagai	waktu	sebagai	6
waktu_sekarang	waktu	sekarang	6
waktu_siang	waktu	siang	6
waktu_terang	waktu	terang	6
waktu_terbang	waktu	terbang	6
waktu_ujian	waktu	ujian	6
ba-tas_waktu	ba-tas	waktu	5
berdasarkan_waktu	berdasarkan	waktu	5
bila_waktu	bila	waktu	5
bukanlah_waktu	bukanlah	waktu	5
dimana_waktu	dimana	waktu	5
fleksibilitas_waktu	fleksibilitas	waktu	5
habiskan_waktu	habiskan	waktu	5
hanya_waktu	hanya	waktu	5
interval_waktu	interval	waktu	5
jatah_waktu	jatah	waktu	5
jelang_waktu	jelang	waktu	5
katanya_waktu	katanya	waktu	5
kecepatan_waktu	kecepatan	waktu	5
kelonggaran_waktu	kelonggaran	waktu	5
kemarin_waktu	kemarin	waktu	5
melewati_waktu	melewati	waktu	5
melihat_waktu	melihat	waktu	5
meman-faatkan_waktu	meman-faatkan	waktu	5
mempercepat_waktu	mempercepat	waktu	5
mengelola_waktu	mengelola	waktu	5
menghargai_waktu	menghargai	waktu	5
menung-gu_waktu	menung-gu	waktu	5
menyesuaikan_waktu	menyesuaikan	waktu	5
meraih_waktu	meraih	waktu	5
nanti_waktu	nanti	waktu	5
penambahan_waktu	penambahan	waktu	5
perolehan_waktu	perolehan	waktu	5
perubahan_waktu	perubahan	waktu	5
sebab_waktu	sebab	waktu	5
segi_waktu	segi	waktu	5
sekitar_waktu	sekitar	waktu	5
semen-tara_waktu	semen-tara	waktu	5
tenaga_waktu	tenaga	waktu	5
teng-gang_waktu	teng-gang	waktu	5
torehan_waktu	torehan	waktu	5
waktu_akhirnya	waktu	akhirnya	5
waktu_buat	waktu	buat	5
waktu_demi	waktu	demi	5
waktu_efektif	waktu	efektif	5
waktu_guna	waktu	guna	5
waktu_jelas	waktu	jelas	5
waktu_ketika	waktu	ketika	5
waktu_kunjungan	waktu	kunjungan	5
waktu_lain	waktu	lain	5
waktu_lap	waktu	lap	5
waktu_layanan	waktu	layanan	5
waktu_liburnya	waktu	liburnya	5
waktu_mau	waktu	mau	5
waktu_membaca	waktu	membaca	5
waktu_menuju	waktu	menuju	5
waktu_operasi	waktu	operasi	5
waktu_pekan	waktu	pekan	5
waktu_pelayanan	waktu	pelayanan	5
waktu_pendek	waktu	pendek	5
waktu_penetapan	waktu	penetapan	5
waktu_pengambilan	waktu	pengambilan	5
waktu_pengembalian	waktu	pengembalian	5
waktu_penilaian	waktu	penilaian	5
waktu_pertemuan	waktu	pertemuan	5
waktu_produksi	waktu	produksi	5
waktu_sambil	waktu	sambil	5
waktu_se-tempat	waktu	se-tempat	5
waktu_sebentar	waktu	sebentar	5
waktu_secepatnya	waktu	secepatnya	5
waktu_sedikitnya	waktu	sedikitnya	5
waktu_setidaknya	waktu	setidaknya	5
waktu_sholat	waktu	sholat	5
waktu_sisa	waktu	sisa	5
waktu_sore	waktu	sore	5
waktu_telah	waktu	telah	5
waktu_ucapnya	waktu	ucapnya	5
waktu_unjuk	waktu	unjuk	5
waktu_warga	waktu	warga	5
waktu_yakni	waktu	yakni	5
zona_waktu	zona	waktu	5
alokasi_waktu	alokasi	waktu	4
antara_waktu	antara	waktu	4
awal_waktu	awal	waktu	4
bagi_waktu	bagi	waktu	4
berapa_waktu	berapa	waktu	4
dua_waktu	dua	waktu	4
estimasi_waktu	estimasi	waktu	4
hitungan_waktu	hitungan	waktu	4
jarak_waktu	jarak	waktu	4
kaget_waktu	kaget	waktu	4
kasih_waktu	kasih	waktu	4
kehabisan_waktu	kehabisan	waktu	4
ku-run_waktu	ku-run	waktu	4
lupa_waktu	lupa	waktu	4
manajemen_waktu	manajemen	waktu	4
masuk_waktu	masuk	waktu	4
melalui_waktu	melalui	waktu	4
membatasi_waktu	membatasi	waktu	4
mencuri_waktu	mencuri	waktu	4
menelan_waktu	menelan	waktu	4
menetapkan_waktu	menetapkan	waktu	4
mengetahui_waktu	mengetahui	waktu	4
mengganggu_waktu	mengganggu	waktu	4
menghitung_waktu	menghitung	waktu	4
menunda_waktu	menunda	waktu	4
menunjukkan_waktu	menunjukkan	waktu	4
menyia-nyiakan_waktu	menyia-nyiakan	waktu	4
mepet_waktu	mepet	waktu	4
pa-da_waktu	pa-da	waktu	4
penetapan_waktu	penetapan	waktu	4
penuh_waktu	penuh	waktu	4
penunjuk_waktu	penunjuk	waktu	4
pergantian_waktu	pergantian	waktu	4
pertimbangan_waktu	pertimbangan	waktu	4
pilihan_waktu	pilihan	waktu	4
pilkada_waktu	pilkada	waktu	4
rentan_waktu	rentan	waktu	4
sekarang_waktu	sekarang	waktu	4
sendiri_waktu	sendiri	waktu	4
serta_waktu	serta	waktu	4
singkatnya_waktu	singkatnya	waktu	4
standar_waktu	standar	waktu	4
tahu_waktu	tahu	waktu	4
te-pat_waktu	te-pat	waktu	4
terhadap_waktu	terhadap	waktu	4
terjadi_waktu	terjadi	waktu	4
termasuk_waktu	termasuk	waktu	4
waktu_acara	waktu	acara	4
waktu_aku	waktu	aku	4
waktu_bahkan	waktu	bahkan	4
waktu_baru	waktu	baru	4
waktu_bekerja	waktu	bekerja	4
waktu_berada	waktu	berada	4
waktu_berikutnya	waktu	berikutnya	4
waktu_berminggu-minggu	waktu	berminggu-minggu	4
waktu_bersih	waktu	bersih	4
waktu_bertemu	waktu	bertemu	4
waktu_buka	waktu	buka	4
waktu_dirinya	waktu	dirinya	4
waktu_dulu	waktu	dulu	4
waktu_hujan	waktu	hujan	4
waktu_ideal	waktu	ideal	4
waktu_jelasnya	waktu	jelasnya	4
waktu_jika	waktu	jika	4
waktu_kredit	waktu	kredit	4
waktu_kuliah	waktu	kuliah	4
waktu_la-lu	waktu	la-lu	4
waktu_lembur	waktu	lembur	4
waktu_maghrib	waktu	maghrib	4
waktu_mandi	waktu	mandi	4
waktu_melihat	waktu	melihat	4
waktu_melontar	waktu	melontar	4
waktu_mengajak	waktu	mengajak	4
waktu_mengikuti	waktu	mengikuti	4
waktu_mulai	waktu	mulai	4
waktu_nanti	waktu	nanti	4
waktu_orang	waktu	orang	4
waktu_panen	waktu	panen	4
waktu_pasti	waktu	pasti	4
waktu_pelak-sanaan	waktu	pelak-sanaan	4
waktu_pelaksana-annya	waktu	pelaksana-annya	4
waktu_peluncuran	waktu	peluncuran	4
waktu_pemakaian	waktu	pemakaian	4
waktu_pembangunan	waktu	pembangunan	4
waktu_pemberian	waktu	pemberian	4
waktu_pembuatan	waktu	pembuatan	4
waktu_penerapan	waktu	penerapan	4
waktu_penerimaan	waktu	penerimaan	4
waktu_pengecekan	waktu	pengecekan	4
waktu_pengerjaannya	waktu	pengerjaannya	4
waktu_perekaman	waktu	perekaman	4
waktu_pergi	waktu	pergi	4
waktu_perut	waktu	perut	4
waktu_rata-rata	waktu	rata-rata	4
waktu_santai	waktu	santai	4
waktu_sedikit	waktu	sedikit	4
waktu_seharian	waktu	seharian	4
waktu_seleksi	waktu	seleksi	4
waktu_sendiri	waktu	sendiri	4
waktu_sewa	waktu	sewa	4
waktu_tempuhnya	waktu	tempuhnya	4
waktu_ter-tentu	waktu	ter-tentu	4
waktu_terbatas	waktu	terbatas	4
waktu_terhadap	waktu	terhadap	4
waktu_terjadi	waktu	terjadi	4
waktu_tetap	waktu	tetap	4
waktu_tetapi	waktu	tetapi	4
waktu_tiba	waktu	tiba	4
waktu_transaksi	waktu	transaksi	4
waktu_tuturnya	waktu	tuturnya	4
waktu_ungkap	waktu	ungkap	4
waktu_yaitu	waktu	yaitu	4
yakni_waktu	yakni	waktu	4
adanya_waktu	adanya	waktu	3
agar_waktu	agar	waktu	3
ambil_waktu	ambil	waktu	3
apakah_waktu	apakah	waktu	3
apalagi_waktu	apalagi	waktu	3
baik_waktu	baik	waktu	3
banyaknya_waktu	banyaknya	waktu	3
beberpa_waktu	beberpa	waktu	3
berharap_waktu	berharap	waktu	3
beri_waktu	beri	waktu	3
berjalan_waktu	berjalan	waktu	3
berselang_waktu	berselang	waktu	3
besar_waktu	besar	waktu	3
biaya_waktu	biaya	waktu	3
bilang_waktu	bilang	waktu	3
bukti_waktu	bukti	waktu	3
cuma_waktu	cuma	waktu	3
dana_waktu	dana	waktu	3
de-ngan_waktu	de-ngan	waktu	3
destinasi_waktu	destinasi	waktu	3
dibandingkan_waktu	dibandingkan	waktu	3
dibatasi_waktu	dibatasi	waktu	3
dicari_waktu	dicari	waktu	3
dimakan_waktu	dimakan	waktu	3
efesiensi_waktu	efesiensi	waktu	3
energi_waktu	energi	waktu	3
faktor_waktu	faktor	waktu	3
ialah_waktu	ialah	waktu	3
ikut_waktu	ikut	waktu	3
isi_waktu	isi	waktu	3
jelas_waktu	jelas	waktu	3
kampanye_waktu	kampanye	waktu	3
kan_waktu	kan	waktu	3
kejadian_waktu	kejadian	waktu	3
kekurangan_waktu	kekurangan	waktu	3
kesiapan_waktu	kesiapan	waktu	3
keterlambatan_waktu	keterlambatan	waktu	3
kondisi_waktu	kondisi	waktu	3
kualitas_waktu	kualitas	waktu	3
kuota_waktu	kuota	waktu	3
legislatif_waktu	legislatif	waktu	3
lorong_waktu	lorong	waktu	3
me-minta_waktu	me-minta	waktu	3
melewatkan_waktu	melewatkan	waktu	3
mem-berikan_waktu	mem-berikan	waktu	3
memang_waktu	memang	waktu	3
memperhitungkan_waktu	memperhitungkan	waktu	3
menawarkan_waktu	menawarkan	waktu	3
mencapai_waktu	mencapai	waktu	3
mencetak_waktu	mencetak	waktu	3
mencurahkan_waktu	mencurahkan	waktu	3
meng-habiskan_waktu	meng-habiskan	waktu	3
meng-ingat_waktu	meng-ingat	waktu	3
mengajar_waktu	mengajar	waktu	3
mengaku_waktu	mengaku	waktu	3
mengalihkan_waktu	mengalihkan	waktu	3
mengingatkan_waktu	mengingatkan	waktu	3
mengubah_waktu	mengubah	waktu	3
menilai_waktu	menilai	waktu	3
menjadwalkan_waktu	menjadwalkan	waktu	3
menjelaskan_waktu	menjelaskan	waktu	3
menorehkan_waktu	menorehkan	waktu	3
menyebutkan_waktu	menyebutkan	waktu	3
mesin_waktu	mesin	waktu	3
muda_waktu	muda	waktu	3
pengisi_waktu	pengisi	waktu	3
penyesuaian_waktu	penyesuaian	waktu	3
perkiraan_waktu	perkiraan	waktu	3
pertandingan_waktu	pertandingan	waktu	3
petang_waktu	petang	waktu	3
ruang_waktu	ruang	waktu	3
secara_waktu	secara	waktu	3
sedangkan_waktu	sedangkan	waktu	3
sejak_waktu	sejak	waktu	3
sekian_waktu	sekian	waktu	3
sela_waktu	sela	waktu	3
seluruh_waktu	seluruh	waktu	3
semua_waktu	semua	waktu	3
sisi_waktu	sisi	waktu	3
siswa_waktu	siswa	waktu	3
skala_waktu	skala	waktu	3
tandasnya_waktu	tandasnya	waktu	3
tegasnya_waktu	tegasnya	waktu	3
tengah_waktu	tengah	waktu	3
terasa_waktu	terasa	waktu	3
terbatas_waktu	terbatas	waktu	3
terkendala_waktu	terkendala	waktu	3
waktu_aksi	waktu	aksi	3
waktu_bahwa	waktu	bahwa	3
waktu_belaka-ngan	waktu	belaka-ngan	3
waktu_berhari-hari	waktu	berhari-hari	3
waktu_berlaga	waktu	berlaga	3
waktu_berlibur	waktu	berlibur	3
waktu_bersa-maan	waktu	bersa-maan	3
waktu_buang	waktu	buang	3
waktu_bukan	waktu	bukan	3
waktu_dana	waktu	dana	3
waktu_dihentikan	waktu	dihentikan	3
waktu_dimana	waktu	dimana	3
waktu_distribusi	waktu	distribusi	3
waktu_ditentukan	waktu	ditentukan	3
waktu_eksekusi	waktu	eksekusi	3
waktu_ekstra	waktu	ekstra	3
waktu_favorit	waktu	favorit	3
waktu_guru	waktu	guru	3
waktu_hadir	waktu	hadir	3
waktu_hal	waktu	hal	3
waktu_harga	waktu	harga	3
waktu_hendak	waktu	hendak	3
waktu_hidupnya	waktu	hidupnya	3
waktu_ibu	waktu	ibu	3
waktu_imbuhnya	waktu	imbuhnya	3
waktu_inilah	waktu	inilah	3
waktu_investasi	waktu	investasi	3
waktu_jatuh	waktu	jatuh	3
waktu_jelang	waktu	jelang	3
waktu_justru	waktu	justru	3
waktu_kampanyenya	waktu	kampanyenya	3
waktu_karantina	waktu	karantina	3
waktu_kedepan	waktu	kedepan	3
waktu_kedua	waktu	kedua	3
waktu_kegiatan	waktu	kegiatan	3
waktu_kembali	waktu	kembali	3
waktu_konsumen	waktu	konsumen	3
waktu_kontrak	waktu	kontrak	3
waktu_kosong	waktu	kosong	3
waktu_makannya	waktu	makannya	3
waktu_masing-masing	waktu	masing-masing	3
waktu_masuk	waktu	masuk	3
waktu_masyarakat	waktu	masyarakat	3
waktu_menengah	waktu	menengah	3
waktu_mengingat	waktu	mengingat	3
waktu_mengurus	waktu	mengurus	3
waktu_merupakan	waktu	merupakan	3
waktu_moratorium	waktu	moratorium	3
waktu_muda	waktu	muda	3
waktu_musim	waktu	musim	3
waktu_operasional	waktu	operasional	3
waktu_pekerjaan	waktu	pekerjaan	3
waktu_pelaksana-an	waktu	pelaksana-an	3
waktu_pelemparan	waktu	pelemparan	3
waktu_pemakaman	waktu	pemakaman	3
waktu_pembayarannya	waktu	pembayarannya	3
waktu_pembongkaran	waktu	pembongkaran	3
waktu_pemungutan	waktu	pemungutan	3
waktu_penayangan	waktu	penayangan	3
waktu_pendidikan	waktu	pendidikan	3
waktu_penembakan	waktu	penembakan	3
waktu_penerbitan	waktu	penerbitan	3
waktu_pensiun	waktu	pensiun	3
waktu_percuma	waktu	percuma	3
waktu_pertarungan	waktu	pertarungan	3
waktu_pikiran	waktu	pikiran	3
waktu_presiden	waktu	presiden	3
waktu_promosi	waktu	promosi	3
waktu_puasa	waktu	puasa	3
waktu_pukul	waktu	pukul	3
waktu_puluhan	waktu	puluhan	3
waktu_pun	waktu	pun	3
waktu_pungkasnya	waktu	pungkasnya	3
waktu_sama	waktu	sama	3
waktu_sekira	waktu	sekira	3
waktu_selalu	waktu	selalu	3
waktu_sempat	waktu	sempat	3
waktu_semua	waktu	semua	3
waktu_senang	waktu	senang	3
waktu_senggangnya	waktu	senggangnya	3
waktu_studi	waktu	studi	3
waktu_tentu	waktu	tentu	3
waktu_ter-sebut	waktu	ter-sebut	3
waktu_terbaiknya	waktu	terbaiknya	3
waktu_terbuang	waktu	terbuang	3
waktu_terdapat	waktu	terdapat	3
waktu_ternyata	waktu	ternyata	3
waktu_tidurnya	waktu	tidurnya	3
waktu_toleransi	waktu	toleransi	3
waktu_tukas	waktu	tukas	3
waktu_tukasnya	waktu	tukasnya	3
waktu_turun	waktu	turun	3
waktu_tutur	waktu	tutur	3
waktu_uji	waktu	uji	3
waktu_un-tuk	waktu	un-tuk	3
waktu_ungkapnya	waktu	ungkapnya	3
waktu_usai	waktu	usai	3
waktu_wukuf	waktu	wukuf	3
waktu_x	waktu	x	3
warga_waktu	warga	waktu	3
wartawan_waktu	wartawan	waktu	3
ya_waktu	ya	waktu	3
ada-lah_waktu	ada-lah	waktu	2
adiknya_waktu	adiknya	waktu	2
aja_waktu	aja	waktu	2
akibat_waktu	akibat	waktu	2
alasan_waktu	alasan	waktu	2
anggaran_waktu	anggaran	waktu	2
aspek_waktu	aspek	waktu	2
atas_waktu	atas	waktu	2
atur_waktu	atur	waktu	2
bagus_waktu	bagus	waktu	2
banget_waktu	banget	waktu	2
beberap_waktu	beberap	waktu	2
beda_waktu	beda	waktu	2
berbeda_waktu	berbeda	waktu	2
bergulirnya_waktu	bergulirnya	waktu	2
berkas_waktu	berkas	waktu	2
bulan_waktu	bulan	waktu	2
bupati_waktu	bupati	waktu	2
cari_waktu	cari	waktu	2
cu-kup_waktu	cu-kup	waktu	2
dalan_waktu	dalan	waktu	2
demikian_waktu	demikian	waktu	2
dengar_waktu	dengar	waktu	2
detik_waktu	detik	waktu	2
dia_waktu	dia	waktu	2
diatur_waktu	diatur	waktu	2
diburu_waktu	diburu	waktu	2
didapat_waktu	didapat	waktu	2
diharapkan_waktu	diharapkan	waktu	2
dihitung_waktu	dihitung	waktu	2
dikarenakan_waktu	dikarenakan	waktu	2
dimensi_waktu	dimensi	waktu	2
dimulai_waktu	dimulai	waktu	2
dipastikan_waktu	dipastikan	waktu	2
diprediksi_waktu	diprediksi	waktu	2
diraih_waktu	diraih	waktu	2
disaat_waktu	disaat	waktu	2
disediakan_waktu	disediakan	waktu	2
dosis_waktu	dosis	waktu	2
efisien_waktu	efisien	waktu	2
foto_waktu	foto	waktu	2
garis_waktu	garis	waktu	2
gubernur_waktu	gubernur	waktu	2
habis_waktu	habis	waktu	2
hadir_waktu	hadir	waktu	2
hearing_waktu	hearing	waktu	2
heran_waktu	heran	waktu	2
ibadahnya_waktu	ibadahnya	waktu	2
ingin_waktu	ingin	waktu	2
jang-ka_waktu	jang-ka	waktu	2
jo_waktu	jo	waktu	2
ka-pan_waktu	ka-pan	waktu	2
ka-rena_waktu	ka-rena	waktu	2
kadang_waktu	kadang	waktu	2
kala_waktu	kala	waktu	2
kapolda_waktu	kapolda	waktu	2
kenapa_waktu	kenapa	waktu	2
kendala_waktu	kendala	waktu	2
kini_waktu	kini	waktu	2
konsultan_waktu	konsultan	waktu	2
konteks_waktu	konteks	waktu	2
kualifikasi_waktu	kualifikasi	waktu	2
kurangi_waktu	kurangi	waktu	2
kurung_waktu	kurung	waktu	2
lakukan_waktu	lakukan	waktu	2
lantaran_waktu	lantaran	waktu	2
latar_waktu	latar	waktu	2
lihat_waktu	lihat	waktu	2
longsor_waktu	longsor	waktu	2
maksimal_waktu	maksimal	waktu	2
maksimalkan_waktu	maksimalkan	waktu	2
masyarakat_waktu	masyarakat	waktu	2
me-manfaatkan_waktu	me-manfaatkan	waktu	2
me-nyisihkan_waktu	me-nyisihkan	waktu	2
melebihi_waktu	melebihi	waktu	2
memandang_waktu	memandang	waktu	2
mematok_waktu	mematok	waktu	2
membeli_waktu	membeli	waktu	2
membuka_waktu	membuka	waktu	2
memer-lukan_waktu	memer-lukan	waktu	2
memikirkan_waktu	memikirkan	waktu	2
memotong_waktu	memotong	waktu	2
mempengaruhi_waktu	mempengaruhi	waktu	2
memperhatikan_waktu	memperhatikan	waktu	2
memperkirakan_waktu	memperkirakan	waktu	2
memperlama_waktu	memperlama	waktu	2
memperoleh_waktu	memperoleh	waktu	2
memperpendek_waktu	memperpendek	waktu	2
mempertanyakan_waktu	mempertanyakan	waktu	2
mempertimbangkan_waktu	mempertimbangkan	waktu	2
memprediksi_waktu	memprediksi	waktu	2
menambah_waktu	menambah	waktu	2
menanti_waktu	menanti	waktu	2
menanyakan_waktu	menanyakan	waktu	2
menekan_waktu	menekan	waktu	2
menemukan_waktu	menemukan	waktu	2
mengabiskan_waktu	mengabiskan	waktu	2
mengefisienkan_waktu	mengefisienkan	waktu	2
mengulur-ngulur_waktu	mengulur-ngulur	waktu	2
mengungkapkan_waktu	mengungkapkan	waktu	2
meningkatkan_waktu	meningkatkan	waktu	2
menjanjikan_waktu	menjanjikan	waktu	2
menjelajahi_waktu	menjelajahi	waktu	2
menunda-nunda_waktu	menunda-nunda	waktu	2
menyamakan_waktu	menyamakan	waktu	2
menyangkut_waktu	menyangkut	waktu	2
menyebut_waktu	menyebut	waktu	2
menyianyiakan_waktu	menyianyiakan	waktu	2
menyiasati_waktu	menyiasati	waktu	2
meru-pakan_waktu	meru-pakan	waktu	2
merugikan_waktu	merugikan	waktu	2
misalnya_waktu	misalnya	waktu	2
mo-lornya_waktu	mo-lornya	waktu	2
mohon_waktu	mohon	waktu	2
mungkin_waktu	mungkin	waktu	2
musda_waktu	musda	waktu	2
namun_waktu	namun	waktu	2
opsi_waktu	opsi	waktu	2
optimalkan_waktu	optimalkan	waktu	2
paksaan_waktu	paksaan	waktu	2
panjang_waktu	panjang	waktu	2
pas_waktu	pas	waktu	2
pasti_waktu	pasti	waktu	2
pastikan_waktu	pastikan	waktu	2
pembatasan_waktu	pembatasan	waktu	2
pemborosan_waktu	pemborosan	waktu	2
pemerintah_waktu	pemerintah	waktu	2
penentuan_waktu	penentuan	waktu	2
pengaturan_waktu	pengaturan	waktu	2
pengorbanan_waktu	pengorbanan	waktu	2
pengujung_waktu	pengujung	waktu	2
pengunduran_waktu	pengunduran	waktu	2
pengurangan_waktu	pengurangan	waktu	2
penundaan_waktu	penundaan	waktu	2
perhitungan_waktu	perhitungan	waktu	2
perkembangan_waktu	perkembangan	waktu	2
persen_waktu	persen	waktu	2
persidangan_waktu	persidangan	waktu	2
pertama_waktu	pertama	waktu	2
pesawat_waktu	pesawat	waktu	2
proses_waktu	proses	waktu	2
pun_waktu	pun	waktu	2
range_waktu	range	waktu	2
rasa_waktu	rasa	waktu	2
rekor_waktu	rekor	waktu	2
rugi_waktu	rugi	waktu	2
sadar_waktu	sadar	waktu	2
salah_waktu	salah	waktu	2
sang_waktu	sang	waktu	2
se-mentara_waktu	se-mentara	waktu	2
se-suai_waktu	se-suai	waktu	2
sebagaimana_waktu	sebagaimana	waktu	2
sebenarnya_waktu	sebenarnya	waktu	2
sediakan_waktu	sediakan	waktu	2
sela-sela_waktu	sela-sela	waktu	2
selepas_waktu	selepas	waktu	2
sementa-ra_waktu	sementa-ra	waktu	2
sempitnya_waktu	sempitnya	waktu	2
sepenuh_waktu	sepenuh	waktu	2
sepertiga_waktu	sepertiga	waktu	2
serapi_waktu	serapi	waktu	2
sewaktu_waktu	sewaktu	waktu	2
shalat_waktu	shalat	waktu	2
situasi_waktu	situasi	waktu	2
suasana_waktu	suasana	waktu	2
supaya_waktu	supaya	waktu	2
tadi_waktu	tadi	waktu	2
tahapan_waktu	tahapan	waktu	2
takut_waktu	takut	waktu	2
tempat_waktu	tempat	waktu	2
tempo_waktu	tempo	waktu	2
terakhir_waktu	terakhir	waktu	2
terbatasnya_waktu	terbatasnya	waktu	2
tergerus_waktu	tergerus	waktu	2
terikat_waktu	terikat	waktu	2
terpaut_waktu	terpaut	waktu	2
terpilih_waktu	terpilih	waktu	2
tersebut_waktu	tersebut	waktu	2
terutama_waktu	terutama	waktu	2
tetapi_waktu	tetapi	waktu	2
tidak_waktu	tidak	waktu	2
wajib_waktu	wajib	waktu	2
waktu_adegan	waktu	adegan	2
waktu_afdal	waktu	afdal	2
waktu_agenda	waktu	agenda	2
waktu_alias	waktu	alias	2
waktu_angsuran	waktu	angsuran	2
waktu_antar	waktu	antar	2
waktu_antrean	waktu	antrean	2
waktu_apalagi	waktu	apalagi	2
waktu_asal	waktu	asal	2
waktu_atas	waktu	atas	2
waktu_ayah	waktu	ayah	2
waktu_bahan	waktu	bahan	2
waktu_baik	waktu	baik	2
waktu_bangun	waktu	bangun	2
waktu_bank	waktu	bank	2
waktu_batas	waktu	batas	2
waktu_beban	waktu	beban	2
waktu_belajarnya	waktu	belajarnya	2
waktu_beliau	waktu	beliau	2
waktu_bencana	waktu	bencana	2
waktu_ber-samaan	waktu	ber-samaan	2
waktu_berakhirnya	waktu	berakhirnya	2
waktu_berapa	waktu	berapa	2
waktu_berbagi	waktu	berbagi	2
waktu_berbenah	waktu	berbenah	2
waktu_berdua	waktu	berdua	2
waktu_beristirahat	waktu	beristirahat	2
waktu_berjualan	waktu	berjualan	2
waktu_berkualitas	waktu	berkualitas	2
waktu_berkunjung	waktu	berkunjung	2
waktu_bermainnya	waktu	bermainnya	2
waktu_berolahraga	waktu	berolahraga	2
waktu_bersantai	waktu	bersantai	2
waktu_bertugas	waktu	bertugas	2
waktu_berturut-turut	waktu	berturut-turut	2
waktu_bicara	waktu	bicara	2
waktu_bolak-balik	waktu	bolak-balik	2
waktu_bursa	waktu	bursa	2
waktu_cicilan	waktu	cicilan	2
waktu_cita-cita	waktu	cita-cita	2
waktu_cuti	waktu	cuti	2
waktu_datang	waktu	datang	2
waktu_demikian	waktu	demikian	2
waktu_demo	waktu	demo	2
waktu_diberlakukan	waktu	diberlakukan	2
waktu_dijemput	waktu	dijemput	2
waktu_dilakukan	waktu	dilakukan	2
waktu_diliburkan	waktu	diliburkan	2
waktu_diperiksa	waktu	diperiksa	2
waktu_disana	waktu	disana	2
waktu_disusul	waktu	disusul	2
waktu_ditarik	waktu	ditarik	2
waktu_diumumkan	waktu	diumumkan	2
waktu_duduk	waktu	duduk	2
waktu_dwelling	waktu	dwelling	2
waktu_ek-sekusi	waktu	ek-sekusi	2
waktu_evakuasi	waktu	evakuasi	2
waktu_evaluasi	waktu	evaluasi	2
waktu_fermentasi	waktu	fermentasi	2
waktu_ground	waktu	ground	2
waktu_habis	waktu	habis	2
waktu_hakim	waktu	hakim	2
waktu_hidup	waktu	hidup	2
waktu_hing-ga	waktu	hing-ga	2
waktu_hitungan	waktu	hitungan	2
waktu_ikut	waktu	ikut	2
waktu_instalasi	waktu	instalasi	2
waktu_jalan	waktu	jalan	2
waktu_jalan-jalan	waktu	jalan-jalan	2
waktu_jamaah	waktu	jamaah	2
waktu_jaman	waktu	jaman	2
waktu_jarak	waktu	jarak	2
waktu_jauh	waktu	jauh	2
waktu_kan	waktu	kan	2
waktu_kebersamaan	waktu	kebersamaan	2
waktu_keduanya	waktu	keduanya	2
waktu_kehamilannya	waktu	kehamilannya	2
waktu_kehidupan	waktu	kehidupan	2
waktu_kelas	waktu	kelas	2
waktu_kesempatan	waktu	kesempatan	2
waktu_kesepakatan	waktu	kesepakatan	2
waktu_keutuhan	waktu	keutuhan	2
waktu_kini	waktu	kini	2
waktu_kompetisi	waktu	kompetisi	2
waktu_konser	waktu	konser	2
waktu_korban	waktu	korban	2
waktu_korupsi	waktu	korupsi	2
waktu_kumpul	waktu	kumpul	2
waktu_lama-lama	waktu	lama-lama	2
waktu_lampu	waktu	lampu	2
waktu_lanjutnya	waktu	lanjutnya	2
waktu_larangan	waktu	larangan	2
waktu_lelang	waktu	lelang	2
waktu_lepas	waktu	lepas	2
waktu_letusan	waktu	letusan	2
waktu_liburannya	waktu	liburannya	2
waktu_longsor	waktu	longsor	2
waktu_lowong	waktu	lowong	2
waktu_lumayan	waktu	lumayan	2
waktu_magrib	waktu	magrib	2
waktu_main	waktu	main	2
waktu_makin	waktu	makin	2
waktu_manusia	waktu	manusia	2
waktu_maupun	waktu	maupun	2
waktu_melakukan	waktu	melakukan	2
waktu_melanda	waktu	melanda	2
waktu_melawan	waktu	melawan	2
waktu_melengkapi	waktu	melengkapi	2
waktu_memang	waktu	memang	2
waktu_memasak	waktu	memasak	2
waktu_membawa	waktu	membawa	2
waktu_membayar	waktu	membayar	2
waktu_memberikan	waktu	memberikan	2
waktu_memulai	waktu	memulai	2
waktu_mencari	waktu	mencari	2
waktu_mendaftar	waktu	mendaftar	2
waktu_mengatur	waktu	mengatur	2
waktu_menghadap	waktu	menghadap	2
waktu_menghadiri	waktu	menghadiri	2
waktu_mengisapnya	waktu	mengisapnya	2
waktu_menguap	waktu	menguap	2
waktu_mengungsi	waktu	mengungsi	2
waktu_meninggal	waktu	meninggal	2
waktu_meninggalkan	waktu	meninggalkan	2
waktu_menjalani	waktu	menjalani	2
waktu_menjelang	waktu	menjelang	2
waktu_menyelesaikan	waktu	menyelesaikan	2
waktu_mepet	waktu	mepet	2
waktu_mustajab	waktu	mustajab	2
waktu_naik	waktu	naik	2
waktu_oleh	waktu	oleh	2
waktu_padahal	waktu	padahal	2
waktu_parkir	waktu	parkir	2
waktu_partai	waktu	partai	2
waktu_pastinya	waktu	pastinya	2
waktu_pe-laksanaan	waktu	pe-laksanaan	2
waktu_pe-laksanaannya	waktu	pe-laksanaannya	2
waktu_pebalap	waktu	pebalap	2
waktu_pelaksa-naan	waktu	pelaksa-naan	2
waktu_pelaksanaan-nya	waktu	pelaksanaan-nya	2
waktu_pelaporan	waktu	pelaporan	2
waktu_pelarangan	waktu	pelarangan	2
waktu_pemanggilan	waktu	pemanggilan	2
waktu_pemasangan	waktu	pemasangan	2
waktu_pembalap	waktu	pembalap	2
waktu_pembenahan	waktu	pembenahan	2
waktu_pemberlakuan	waktu	pemberlakuan	2
waktu_pembukaan	waktu	pembukaan	2
waktu_pembuktian	waktu	pembuktian	2
waktu_pemekaran	waktu	pemekaran	2
waktu_pemerik-saan	waktu	pemerik-saan	2
waktu_pemerintah	waktu	pemerintah	2
waktu_pemusnahan	waktu	pemusnahan	2
waktu_pendekatan	waktu	pendekatan	2
waktu_penebusan	waktu	penebusan	2
waktu_pengajuannya	waktu	pengajuannya	2
waktu_penggunaan	waktu	penggunaan	2
waktu_penjemputan	waktu	penjemputan	2
waktu_penting	waktu	penting	2
waktu_penya-luran	waktu	penya-luran	2
waktu_penyampaian	waktu	penyampaian	2
waktu_penyelengga-raan	waktu	penyelengga-raan	2
waktu_penyelidikan	waktu	penyelidikan	2
waktu_penyetoran	waktu	penyetoran	2
waktu_peran	waktu	peran	2
waktu_perawatan	waktu	perawatan	2
waktu_perdagangan	waktu	perdagangan	2
waktu_peresmian	waktu	peresmian	2
waktu_periode	waktu	periode	2
waktu_peristiwa	waktu	peristiwa	2
waktu_perizinan	waktu	perizinan	2
waktu_perkembangan	waktu	perkembangan	2
waktu_personel	waktu	personel	2
waktu_pinjaman	waktu	pinjaman	2
waktu_program	waktu	program	2
waktu_proyek	waktu	proyek	2
waktu_puncak	waktu	puncak	2
waktu_punctual	waktu	punctual	2
waktu_putaran	waktu	putaran	2
waktu_ratusan	waktu	ratusan	2
waktu_reaksi	waktu	reaksi	2
waktu_reformasi	waktu	reformasi	2
waktu_rehat	waktu	rehat	2
waktu_remaja	waktu	remaja	2
waktu_resmi	waktu	resmi	2
waktu_ribu	waktu	ribu	2
waktu_se-kitar	waktu	se-kitar	2
waktu_sebagian	waktu	sebagian	2
waktu_sedang	waktu	sedang	2
waktu_sedangkan	waktu	sedangkan	2
waktu_segera	waktu	segera	2
waktu_seki-tar	waktu	seki-tar	2
waktu_selambat-lambatnya	waktu	selambat-lambatnya	2
waktu_semalam	waktu	semalam	2
waktu_sembari	waktu	sembari	2
waktu_sempit	waktu	sempit	2
waktu_sendirian	waktu	sendirian	2
waktu_seorang	waktu	seorang	2
waktu_sesudahnya	waktu	sesudahnya	2
waktu_setem-pat	waktu	setem-pat	2
waktu_setempa	waktu	setempa	2
waktu_si	waktu	si	2
waktu_sibuk	waktu	sibuk	2
waktu_sidang	waktu	sidang	2
waktu_skor	waktu	skor	2
waktu_submit	waktu	submit	2
waktu_susah	waktu	susah	2
waktu_tambahkan	waktu	tambahkan	2
waktu_tanam	waktu	tanam	2
waktu_tandas	waktu	tandas	2
waktu_tandasnya	waktu	tandasnya	2
waktu_target	waktu	target	2
waktu_tegas	waktu	tegas	2
waktu_tempat	waktu	tempat	2
waktu_tengah	waktu	tengah	2
waktu_tepatnya	waktu	tepatnya	2
waktu_terbesar	waktu	terbesar	2
waktu_terbit	waktu	terbit	2
waktu_terkait	waktu	terkait	2
waktu_terlalu	waktu	terlalu	2
waktu_tersendiri	waktu	tersendiri	2
waktu_terten-tu	waktu	terten-tu	2
waktu_tim	waktu	tim	2
waktu_torang	waktu	torang	2
waktu_ucap	waktu	ucap	2
waktu_utama	waktu	utama	2
waktu_verifikasi	waktu	verifikasi	2
waktu_zaman	waktu	zaman	2
wasit_waktu	wasit	waktu	2
yaitu_waktu	yaitu	waktu	2
250cc_waktu	250cc	waktu	1
adalan_waktu	adalan	waktu	1
adik_waktu	adik	waktu	1
agendakan_waktu	agendakan	waktu	1
agung_waktu	agung	waktu	1
ahli_waktu	ahli	waktu	1
akan_waktu	akan	waktu	1
akhirnya_waktu	akhirnya	waktu	1
aktivis_waktu	aktivis	waktu	1
aku_waktu	aku	waktu	1
akui_waktu	akui	waktu	1
akunya_waktu	akunya	waktu	1
alias_waktu	alias	waktu	1
alkohol_waktu	alkohol	waktu	1
alokasikan_waktu	alokasikan	waktu	1
alternatif_waktu	alternatif	waktu	1
an-tar_waktu	an-tar	waktu	1
andaikan_waktu	andaikan	waktu	1
angka_waktu	angka	waktu	1
apa-apa_waktu	apa-apa	waktu	1
arti_waktu	arti	waktu	1
artinya_waktu	artinya	waktu	1
atap_waktu	atap	waktu	1
aturan_waktu	aturan	waktu	1
ayah_waktu	ayah	waktu	1
ayah-ibu_waktu	ayah-ibu	waktu	1
ayat_waktu	ayat	waktu	1
bagaimana_waktu	bagaimana	waktu	1
bahagia_waktu	bahagia	waktu	1
bahkan_waktu	bahkan	waktu	1
baik-baik_waktu	baik-baik	waktu	1
balik_waktu	balik	waktu	1
bandara_waktu	bandara	waktu	1
banding_waktu	banding	waktu	1
bangun_waktu	bangun	waktu	1
banjir_waktu	banjir	waktu	1
batas-an_waktu	batas-an	waktu	1
be-ri_waktu	be-ri	waktu	1
beban_waktu	beban	waktu	1
bebarapa_waktu	bebarapa	waktu	1
bebeberapa_waktu	bebeberapa	waktu	1
beberapapa_waktu	beberapapa	waktu	1
bebrapa_waktu	bebrapa	waktu	1
beebrapa_waktu	beebrapa	waktu	1
beli_waktu	beli	waktu	1
beliau_waktu	beliau	waktu	1
belukar_waktu	belukar	waktu	1
ben-cana_waktu	ben-cana	waktu	1
bencana_waktu	bencana	waktu	1
benda_waktu	benda	waktu	1
ber-jalannya_waktu	ber-jalannya	waktu	1
ber-selang_waktu	ber-selang	waktu	1
berakhirnya_waktu	berakhirnya	waktu	1
beralasan_waktu	beralasan	waktu	1
berarti_waktu	berarti	waktu	1
berat_waktu	berat	waktu	1
berbagi_waktu	berbagi	waktu	1
berbatas_waktu	berbatas	waktu	1
berberapa_waktu	berberapa	waktu	1
berburu_waktu	berburu	waktu	1
bercatatan_waktu	bercatatan	waktu	1
berebut_waktu	berebut	waktu	1
berharganya_waktu	berharganya	waktu	1
berhemat_waktu	berhemat	waktu	1
berimbang_waktu	berimbang	waktu	1
berja-lannya_waktu	berja-lannya	waktu	1
berjalanannya_waktu	berjalanannya	waktu	1
berjalanya_waktu	berjalanya	waktu	1
berkesan_waktu	berkesan	waktu	1
berkomitmen_waktu	berkomitmen	waktu	1
berkurangnya_waktu	berkurangnya	waktu	1
bero-perasi_waktu	bero-perasi	waktu	1
berpikir_waktu	berpikir	waktu	1
bersamaan_waktu	bersamaan	waktu	1
bertambahnya_waktu	bertambahnya	waktu	1
bertenaga_waktu	bertenaga	waktu	1
bertepatan_waktu	bertepatan	waktu	1
berubah_waktu	berubah	waktu	1
betapa_waktu	betapa	waktu	1
betul_waktu	betul	waktu	1
biarlah_waktu	biarlah	waktu	1
bica-ranya_waktu	bica-ranya	waktu	1
bijak_waktu	bijak	waktu	1
bingung_waktu	bingung	waktu	1
bisa-bisa_waktu	bisa-bisa	waktu	1
bisae_waktu	bisae	waktu	1
blog_waktu	blog	waktu	1
boros_waktu	boros	waktu	1
bu-tuh_waktu	bu-tuh	waktu	1
buahnya_waktu	buahnya	waktu	1
buruk_waktu	buruk	waktu	1
butuhkan_waktu	butuhkan	waktu	1
cedera_waktu	cedera	waktu	1
cepat_waktu	cepat	waktu	1
cerita_waktu	cerita	waktu	1
cita-citanya_waktu	cita-citanya	waktu	1
contoh_waktu	contoh	waktu	1
cu-ma_waktu	cu-ma	waktu	1
cuaca_waktu	cuaca	waktu	1
curi-curi_waktu	curi-curi	waktu	1
da-ri_waktu	da-ri	waktu	1
daerah_waktu	daerah	waktu	1
daging_waktu	daging	waktu	1
dalanm_waktu	dalanm	waktu	1
dalm_waktu	dalm	waktu	1
dancer_waktu	dancer	waktu	1
dapat_waktu	dapat	waktu	1
datang_waktu	datang	waktu	1
deh_waktu	deh	waktu	1
dekat_waktu	dekat	waktu	1
dekatnya_waktu	dekatnya	waktu	1
demi_waktu	demi	waktu	1
demo_waktu	demo	waktu	1
demokrasi_waktu	demokrasi	waktu	1
denga_waktu	denga	waktu	1
depe_waktu	depe	waktu	1
detail_waktu	detail	waktu	1
detik-detik_waktu	detik-detik	waktu	1
dewan_waktu	dewan	waktu	1
di-beri_waktu	di-beri	waktu	1
di-buka_waktu	di-buka	waktu	1
di-deadline_waktu	di-deadline	waktu	1
di-hadapi_waktu	di-hadapi	waktu	1
di-kasih_waktu	di-kasih	waktu	1
di-perlukan_waktu	di-perlukan	waktu	1
di-pilih_waktu	di-pilih	waktu	1
diajukan_waktu	diajukan	waktu	1
diakomodir_waktu	diakomodir	waktu	1
dialami_waktu	dialami	waktu	1
diantaranya_waktu	diantaranya	waktu	1
diawal_waktu	diawal	waktu	1
dibaandingkan_waktu	dibaandingkan	waktu	1
dibego-begoin_waktu	dibego-begoin	waktu	1
diberitahu_waktu	diberitahu	waktu	1
dibicarakan_waktu	dibicarakan	waktu	1
dibu-tuhkan_waktu	dibu-tuhkan	waktu	1
dibuktikan_waktu	dibuktikan	waktu	1
dibutuh_waktu	dibutuh	waktu	1
dibutuh-kan_waktu	dibutuh-kan	waktu	1
dibutuh-kannya_waktu	dibutuh-kannya	waktu	1
dicairkan_waktu	dicairkan	waktu	1
dicantumkan_waktu	dicantumkan	waktu	1
didapatnya_waktu	didapatnya	waktu	1
digilas_waktu	digilas	waktu	1
dihadapi_waktu	dihadapi	waktu	1
diikrarkan_waktu	diikrarkan	waktu	1
diingat_waktu	diingat	waktu	1
dijaga_waktu	dijaga	waktu	1
dijanjikan_waktu	dijanjikan	waktu	1
dijatahi_waktu	dijatahi	waktu	1
dikandangkan_waktu	dikandangkan	waktu	1
dikarena-kan_waktu	dikarena-kan	waktu	1
dikasih_waktu	dikasih	waktu	1
dikatakan_waktu	dikatakan	waktu	1
diketahui_waktu	diketahui	waktu	1
diklat_waktu	diklat	waktu	1
dikorupsi_waktu	dikorupsi	waktu	1
dilain_waktu	dilain	waktu	1
dilaku-kan_waktu	dilaku-kan	waktu	1
dilakukan_waktu	dilakukan	waktu	1
dilekang_waktu	dilekang	waktu	1
dimanja_waktu	dimanja	waktu	1
dipanggil_waktu	dipanggil	waktu	1
diperkirakan_waktu	diperkirakan	waktu	1
diperpanjang_waktu	diperpanjang	waktu	1
dipertimbangkan_waktu	dipertimbangkan	waktu	1
dipindah_waktu	dipindah	waktu	1
direktur_waktu	direktur	waktu	1
diri_waktu	diri	waktu	1
dirinya_waktu	dirinya	waktu	1
disampaikan_waktu	disampaikan	waktu	1
disana_waktu	disana	waktu	1
disebabkan_waktu	disebabkan	waktu	1
disebut_waktu	disebut	waktu	1
disela_waktu	disela	waktu	1
diseleksi_waktu	diseleksi	waktu	1
disepakati_waktu	disepakati	waktu	1
disesuaikan_waktu	disesuaikan	waktu	1
disiapkan_waktu	disiapkan	waktu	1
disimpan_waktu	disimpan	waktu	1
disimpulkan_waktu	disimpulkan	waktu	1
disini_waktu	disini	waktu	1
disorientasi_waktu	disorientasi	waktu	1
dispensasi_waktu	dispensasi	waktu	1
ditambah_waktu	ditambah	waktu	1
ditentukan_waktu	ditentukan	waktu	1
ditertibkan_waktu	ditertibkan	waktu	1
ditetapkan_waktu	ditetapkan	waktu	1
dituntut_waktu	dituntut	waktu	1
diurus_waktu	diurus	waktu	1
diusulkan_waktu	diusulkan	waktu	1
diwacanakan_waktu	diwacanakan	waktu	1
djam_waktu	djam	waktu	1
dokter_waktu	dokter	waktu	1
donatur_waktu	donatur	waktu	1
drama_waktu	drama	waktu	1
drum_waktu	drum	waktu	1
dugaan_waktu	dugaan	waktu	1
dukung_waktu	dukung	waktu	1
dunia_waktu	dunia	waktu	1
duta-duta_waktu	duta-duta	waktu	1
eberapa_waktu	eberapa	waktu	1
efektivitas_waktu	efektivitas	waktu	1
ekstra_waktu	ekstra	waktu	1
empat_waktu	empat	waktu	1
empunya_waktu	empunya	waktu	1
enak_waktu	enak	waktu	1
enjoy_waktu	enjoy	waktu	1
farmasi_waktu	farmasi	waktu	1
fasili-tas_waktu	fasili-tas	waktu	1
foya-foya_waktu	foya-foya	waktu	1
full_waktu	full	waktu	1
galau_waktu	galau	waktu	1
gambaran_waktu	gambaran	waktu	1
ganjalan_waktu	ganjalan	waktu	1
gap_waktu	gap	waktu	1
gereja_waktu	gereja	waktu	1
gila_waktu	gila	waktu	1
gol_waktu	gol	waktu	1
got_waktu	got	waktu	1
gu-nanya_waktu	gu-nanya	waktu	1
haji_waktu	haji	waktu	1
hal_waktu	hal	waktu	1
halnya_waktu	halnya	waktu	1
harga_waktu	harga	waktu	1
hidup_waktu	hidup	waktu	1
ia_waktu	ia	waktu	1
ice-ice_waktu	ice-ice	waktu	1
ideal_waktu	ideal	waktu	1
idealnya_waktu	idealnya	waktu	1
ikuti_waktu	ikuti	waktu	1
imana_waktu	imana	waktu	1
indekos_waktu	indekos	waktu	1
informasi_waktu	informasi	waktu	1
infrastruktur_waktu	infrastruktur	waktu	1
ingatan_waktu	ingatan	waktu	1
ingatannya_waktu	ingatannya	waktu	1
inter-val_waktu	inter-val	waktu	1
internal_waktu	internal	waktu	1
istilah_waktu	istilah	waktu	1
isyaratnya_waktu	isyaratnya	waktu	1
itulah_waktu	itulah	waktu	1
ja-batan_waktu	ja-batan	waktu	1
jadwal_waktu	jadwal	waktu	1
jago_waktu	jago	waktu	1
jalannya_waktu	jalannya	waktu	1
jangan_waktu	jangan	waktu	1
jangkan_waktu	jangkan	waktu	1
janji_waktu	janji	waktu	1
janjinya_waktu	janjinya	waktu	1
jarang_waktu	jarang	waktu	1
jaringan_waktu	jaringan	waktu	1
jauh_waktu	jauh	waktu	1
jawab_waktu	jawab	waktu	1
jelaskan_waktu	jelaskan	waktu	1
jenis_waktu	jenis	waktu	1
jumlahnya_waktu	jumlahnya	waktu	1
ka-lau_waktu	ka-lau	waktu	1
kabupaten_waktu	kabupaten	waktu	1
kacamata_waktu	kacamata	waktu	1
kadaluarsa_waktu	kadaluarsa	waktu	1
kajian_waktu	kajian	waktu	1
kakak_waktu	kakak	waktu	1
kakek_waktu	kakek	waktu	1
kalanya_waktu	kalanya	waktu	1
kali_waktu	kali	waktu	1
kalian_waktu	kalian	waktu	1
kamu_waktu	kamu	waktu	1
kantor_waktu	kantor	waktu	1
kapsul_waktu	kapsul	waktu	1
karcis_waktu	karcis	waktu	1
kare-na_waktu	kare-na	waktu	1
kase_waktu	kase	waktu	1
kasipnya_waktu	kasipnya	waktu	1
kasus_waktu	kasus	waktu	1
kata-kan_waktu	kata-kan	waktu	1
katakanlah_waktu	katakanlah	waktu	1
kategori_waktu	kategori	waktu	1
ke-juaraan_waktu	ke-juaraan	waktu	1
ke-pastian_waktu	ke-pastian	waktu	1
ke-rangka_waktu	ke-rangka	waktu	1
ke-sedian_waktu	ke-sedian	waktu	1
ke-tepatan_waktu	ke-tepatan	waktu	1
ke-tetapan_waktu	ke-tetapan	waktu	1
keadaan_waktu	keadaan	waktu	1
keberhasi-lan_waktu	keberhasi-lan	waktu	1
kebutuhan_waktu	kebutuhan	waktu	1
keduanya_waktu	keduanya	waktu	1
kejar-kejaran_waktu	kejar-kejaran	waktu	1
kejelasan_waktu	kejelasan	waktu	1
kejurda_waktu	kejurda	waktu	1
kejutan_waktu	kejutan	waktu	1
kekuatan_waktu	kekuatan	waktu	1
kelewat_waktu	kelewat	waktu	1
kelihatannya_waktu	kelihatannya	waktu	1
keliru_waktu	keliru	waktu	1
kelongaran_waktu	kelongaran	waktu	1
keluar_waktu	keluar	waktu	1
kemacetan_waktu	kemacetan	waktu	1
kemah_waktu	kemah	waktu	1
kemana-mana_waktu	kemana-mana	waktu	1
kembali_waktu	kembali	waktu	1
kemudian_waktu	kemudian	waktu	1
kemungkina_waktu	kemungkina	waktu	1
ken-dala_waktu	ken-dala	waktu	1
kenangan_waktu	kenangan	waktu	1
kencang_waktu	kencang	waktu	1
kendaraan_waktu	kendaraan	waktu	1
kenegaraan_waktu	kenegaraan	waktu	1
kepada_waktu	kepada	waktu	1
kepikiran_waktu	kepikiran	waktu	1
kerja_waktu	kerja	waktu	1
kerjaan_waktu	kerjaan	waktu	1
kerjakan_waktu	kerjakan	waktu	1
kesatuan_waktu	kesatuan	waktu	1
kesediaan_waktu	kesediaan	waktu	1
keseluruhan_waktu	keseluruhan	waktu	1
kesempatan_waktu	kesempatan	waktu	1
kesengsaraan_waktu	kesengsaraan	waktu	1
kesepakat-an_waktu	kesepakat-an	waktu	1
kesepakatan_waktu	kesepakatan	waktu	1
kesibukan_waktu	kesibukan	waktu	1
kesimpulannya_waktu	kesimpulannya	waktu	1
ketat_waktu	ketat	waktu	1
ketentuan_waktu	ketentuan	waktu	1
ketepa-tan_waktu	ketepa-tan	waktu	1
keter-batasan_waktu	keter-batasan	waktu	1
keterangan_waktu	keterangan	waktu	1
keterpurukan_waktu	keterpurukan	waktu	1
ketersediaan_waktu	ketersediaan	waktu	1
ketidaksesuai_waktu	ketidaksesuai	waktu	1
ketiga_waktu	ketiga	waktu	1
keuangan_waktu	keuangan	waktu	1
khusus_waktu	khusus	waktu	1
khususnya_waktu	khususnya	waktu	1
kira_waktu	kira	waktu	1
kiranya_waktu	kiranya	waktu	1
kisaran_waktu	kisaran	waktu	1
klenteng_waktu	klenteng	waktu	1
klub_waktu	klub	waktu	1
kok_waktu	kok	waktu	1
kon-sultasi_waktu	kon-sultasi	waktu	1
konsep_waktu	konsep	waktu	1
kontraktor_waktu	kontraktor	waktu	1
korban_waktu	korban	waktu	1
korup-si_waktu	korup-si	waktu	1
kota_waktu	kota	waktu	1
kotor_waktu	kotor	waktu	1
kuantitas_waktu	kuantitas	waktu	1
kudeta_waktu	kudeta	waktu	1
kurang_waktu	kurang	waktu	1
kursi_waktu	kursi	waktu	1
lah_waktu	lah	waktu	1
lainnya_waktu	lainnya	waktu	1
lambannya_waktu	lambannya	waktu	1
lancar_waktu	lancar	waktu	1
langka_waktu	langka	waktu	1
langkah_waktu	langkah	waktu	1
langsung_waktu	langsung	waktu	1
lapangan_waktu	lapangan	waktu	1
laporan_waktu	laporan	waktu	1
latihan_waktu	latihan	waktu	1
lawan_waktu	lawan	waktu	1
lebaran_waktu	lebaran	waktu	1
lekang_waktu	lekang	waktu	1
li-mit_waktu	li-mit	waktu	1
liburan_waktu	liburan	waktu	1
line_waktu	line	waktu	1
lolos_waktu	lolos	waktu	1
long-sor_waktu	long-sor	waktu	1
longgarnya_waktu	longgarnya	waktu	1
lukan_waktu	lukan	waktu	1
lumayan_waktu	lumayan	waktu	1
ma-kan_waktu	ma-kan	waktu	1
ma-lam_waktu	ma-lam	waktu	1
macam_waktu	macam	waktu	1
macetnya_waktu	macetnya	waktu	1
malu_waktu	malu	waktu	1
mama_waktu	mama	waktu	1
mamakan_waktu	mamakan	waktu	1
manajer_waktu	manajer	waktu	1
mandi_waktu	mandi	waktu	1
mar_waktu	mar	waktu	1
marah_waktu	marah	waktu	1
masa-lah_waktu	masa-lah	waktu	1
masuknya_waktu	masuknya	waktu	1
matanya_waktu	matanya	waktu	1
me-lampaui_waktu	me-lampaui	waktu	1
me-lepas_waktu	me-lepas	waktu	1
me-mang_waktu	me-mang	waktu	1
me-merlukan_waktu	me-merlukan	waktu	1
me-miliki_waktu	me-miliki	waktu	1
me-netapkan_waktu	me-netapkan	waktu	1
me-ngatakan_waktu	me-ngatakan	waktu	1
me-ngatur_waktu	me-ngatur	waktu	1
me-ngisi_waktu	me-ngisi	waktu	1
me-ngorbankan_waktu	me-ngorbankan	waktu	1
me-nyediakan_waktu	me-nyediakan	waktu	1
me-nyita_waktu	me-nyita	waktu	1
me-rinci_waktu	me-rinci	waktu	1
meja_waktu	meja	waktu	1
melakukan_waktu	melakukan	waktu	1
melampaui_waktu	melampaui	waktu	1
melanjutkan_waktu	melanjutkan	waktu	1
melaporkan_waktu	melaporkan	waktu	1
melemah_waktu	melemah	waktu	1
melu-angkan_waktu	melu-angkan	waktu	1
mem-buat_waktu	mem-buat	waktu	1
mem-perkirakan_waktu	mem-perkirakan	waktu	1
memahami_waktu	memahami	waktu	1
memakai_waktu	memakai	waktu	1
memaksakan_waktu	memaksakan	waktu	1
memaksimalkan_waktu	memaksimalkan	waktu	1
memanajemen_waktu	memanajemen	waktu	1
memanfaaktan_waktu	memanfaaktan	waktu	1
memanfaat-kan_waktu	memanfaat-kan	waktu	1
memanfaatkan_waktu	memanfaatkan	waktu	1
memantau_waktu	memantau	waktu	1
memaparkan_waktu	memaparkan	waktu	1
memapas_waktu	memapas	waktu	1
membahas_waktu	membahas	waktu	1
membe-rikan_waktu	membe-rikan	waktu	1
membedakan_waktu	membedakan	waktu	1
membeludak_waktu	membeludak	waktu	1
memberi-kan_waktu	memberi-kan	waktu	1
memberitahukan_waktu	memberitahukan	waktu	1
membunuh_waktu	membunuh	waktu	1
membutuh_waktu	membutuh	waktu	1
membutuh-kan_waktu	membutuh-kan	waktu	1
membutukan_waktu	membutukan	waktu	1
memecahkan_waktu	memecahkan	waktu	1
memenuhi_waktu	memenuhi	waktu	1
memesan_waktu	memesan	waktu	1
memi-liki_waktu	memi-liki	waktu	1
memilik_waktu	memilik	waktu	1
memilki_waktu	memilki	waktu	1
memin-ta_waktu	memin-ta	waktu	1
memparuh_waktu	memparuh	waktu	1
mempedulikan_waktu	mempedulikan	waktu	1
memper-panjang_waktu	memper-panjang	waktu	1
mempers-ingkat_waktu	mempers-ingkat	waktu	1
mempersiapkan_waktu	mempersiapkan	waktu	1
mempersoalkan_waktu	mempersoalkan	waktu	1
memuas-kan_waktu	memuas-kan	waktu	1
memungkinkan_waktu	memungkinkan	waktu	1
memungkiri_waktu	memungkiri	waktu	1
memutar_waktu	memutar	waktu	1
men-capai_waktu	men-capai	waktu	1
men-catat_waktu	men-catat	waktu	1
menam-bah_waktu	menam-bah	waktu	1
menam-bahkan_waktu	menam-bahkan	waktu	1
menambah-nambah_waktu	menambah-nambah	waktu	1
menambahkan_waktu	menambahkan	waktu	1
menampik_waktu	menampik	waktu	1
menargetkan_waktu	menargetkan	waktu	1
menca-tat_waktu	menca-tat	waktu	1
mencarikan_waktu	mencarikan	waktu	1
mencata_waktu	mencata	waktu	1
mencetakkan_waktu	mencetakkan	waktu	1
mencintai_waktu	mencintai	waktu	1
menciptakan_waktu	menciptakan	waktu	1
mencoret-coretnya_waktu	mencoret-coretnya	waktu	1
mencuri-curi_waktu	mencuri-curi	waktu	1
menda-patkan_waktu	menda-patkan	waktu	1
mendapat_waktu	mendapat	waktu	1
mendengar_waktu	mendengar	waktu	1
menean_waktu	menean	waktu	1
menebus_waktu	menebus	waktu	1
menemani_waktu	menemani	waktu	1
menen-tukan_waktu	menen-tukan	waktu	1
menentang_waktu	menentang	waktu	1
menepati_waktu	menepati	waktu	1
mengagendakan_waktu	mengagendakan	waktu	1
mengakui_waktu	mengakui	waktu	1
mengalahkan_waktu	mengalahkan	waktu	1
mengalokasi_waktu	mengalokasi	waktu	1
mengalokasikan_waktu	mengalokasikan	waktu	1
menganalisis_waktu	menganalisis	waktu	1
mengang-gap_waktu	mengang-gap	waktu	1
menganggap_waktu	menganggap	waktu	1
mengarungi_waktu	mengarungi	waktu	1
menge-fektifkan_waktu	menge-fektifkan	waktu	1
menge-nal_waktu	menge-nal	waktu	1
mengefektifkan_waktu	mengefektifkan	waktu	1
mengenang_waktu	mengenang	waktu	1
mengenyampingkan_waktu	mengenyampingkan	waktu	1
mengerjak_waktu	mengerjak	waktu	1
menggabungkan_waktu	menggabungkan	waktu	1
menggodoknya_waktu	menggodoknya	waktu	1
mengguna-kan_waktu	mengguna-kan	waktu	1
mengha-biskan_waktu	mengha-biskan	waktu	1
menghabisi_waktu	menghabisi	waktu	1
menghitung-hitung_waktu	menghitung-hitung	waktu	1
menghormati_waktu	menghormati	waktu	1
menginginkan_waktu	menginginkan	waktu	1
mengintervensi_waktu	mengintervensi	waktu	1
mengisyaratkan_waktu	mengisyaratkan	waktu	1
mengkaji_waktu	mengkaji	waktu	1
mengkambing-hitamkan_waktu	mengkambing-hitamkan	waktu	1
mengontrol_waktu	mengontrol	waktu	1
mengukir_waktu	mengukir	waktu	1
mengulang_waktu	mengulang	waktu	1
mengumpulkan_waktu	mengumpulkan	waktu	1
mengungkap_waktu	mengungkap	waktu	1
menguras_waktu	menguras	waktu	1
mengurus_waktu	mengurus	waktu	1
mengurusnya_waktu	mengurusnya	waktu	1
menik-mati_waktu	menik-mati	waktu	1
meninggalkan_waktu	meninggalkan	waktu	1
menjadikan_waktu	menjadikan	waktu	1
menjaga_waktu	menjaga	waktu	1
menjalani_waktu	menjalani	waktu	1
menjanji-kan_waktu	menjanji-kan	waktu	1
menoreh_waktu	menoreh	waktu	1
menu-tup_waktu	menu-tup	waktu	1
menunjukan_waktu	menunjukan	waktu	1
menuntut_waktu	menuntut	waktu	1
menuturkan_waktu	menuturkan	waktu	1
menya-takan_waktu	menya-takan	waktu	1
menyadari_waktu	menyadari	waktu	1
menyarankan_waktu	menyarankan	waktu	1
menyatakan_waktu	menyatakan	waktu	1
menyatukan_waktu	menyatukan	waktu	1
menye-suaikan_waktu	menye-suaikan	waktu	1
menyebabkan_waktu	menyebabkan	waktu	1
menyempat-kan_waktu	menyempat-kan	waktu	1
menyentuh_waktu	menyentuh	waktu	1
menyepatkan_waktu	menyepatkan	waktu	1
menyesalkan_waktu	menyesalkan	waktu	1
menyewa_waktu	menyewa	waktu	1
menyusutnya_waktu	menyusutnya	waktu	1
mepet-mepet_waktu	mepet-mepet	waktu	1
mepet-nya_waktu	mepet-nya	waktu	1
merahasiakan_waktu	merahasiakan	waktu	1
merasa_waktu	merasa	waktu	1
merasakan_waktu	merasakan	waktu	1
merawat_waktu	merawat	waktu	1
mere-ka_waktu	mere-ka	waktu	1
merealisasikannya_waktu	merealisasikannya	waktu	1
mereduksi_waktu	mereduksi	waktu	1
merekomendasikan_waktu	merekomendasikan	waktu	1
merendahkan_waktu	merendahkan	waktu	1
merevisi_waktu	merevisi	waktu	1
merinding_waktu	merinding	waktu	1
merintang_waktu	merintang	waktu	1
merubah_waktu	merubah	waktu	1
merunut_waktu	merunut	waktu	1
merupa-kan_waktu	merupa-kan	waktu	1
merupakaan_waktu	merupakaan	waktu	1
mewakafkan_waktu	mewakafkan	waktu	1
miliki_waktu	miliki	waktu	1
minim_waktu	minim	waktu	1
minimal_waktu	minimal	waktu	1
mismatch_waktu	mismatch	waktu	1
mobil_waktu	mobil	waktu	1
moneter_waktu	moneter	waktu	1
mood_waktu	mood	waktu	1
motor_waktu	motor	waktu	1
mudik_waktu	mudik	waktu	1
mula_waktu	mula	waktu	1
mulai_waktu	mulai	waktu	1
multimedia_waktu	multimedia	waktu	1
mulut_waktu	mulut	waktu	1
mundurnya_waktu	mundurnya	waktu	1
muslim_waktu	muslim	waktu	1
mutu_waktu	mutu	waktu	1
naik_waktu	naik	waktu	1
nakal_waktu	nakal	waktu	1
nasi_waktu	nasi	waktu	1
nasional_waktu	nasional	waktu	1
nego-nego_waktu	nego-nego	waktu	1
nentuin_waktu	nentuin	waktu	1
ngasih_waktu	ngasih	waktu	1
ngomong_waktu	ngomong	waktu	1
nikmatin_waktu	nikmatin	waktu	1
no_waktu	no	waktu	1
normal_waktu	normal	waktu	1
nulisnya_waktu	nulisnya	waktu	1
nung-gu_waktu	nung-gu	waktu	1
obral_waktu	obral	waktu	1
orang_waktu	orang	waktu	1
orangtuanya_waktu	orangtuanya	waktu	1
organisasi_waktu	organisasi	waktu	1
pa-dahal_waktu	pa-dahal	waktu	1
pa-ruh_waktu	pa-ruh	waktu	1
padat_waktu	padat	waktu	1
pakai_waktu	pakai	waktu	1
pandang_waktu	pandang	waktu	1
panen_waktu	panen	waktu	1
panjangnya_waktu	panjangnya	waktu	1
papan_waktu	papan	waktu	1
parah_waktu	parah	waktu	1
partai_waktu	partai	waktu	1
pastinya_waktu	pastinya	waktu	1
patokan_waktu	patokan	waktu	1
pe-nambahan_waktu	pe-nambahan	waktu	1
pe-nunjuk_waktu	pe-nunjuk	waktu	1
peduli_waktu	peduli	waktu	1
pegawai_waktu	pegawai	waktu	1
pelabuhan_waktu	pelabuhan	waktu	1
pelaksanaan_waktu	pelaksanaan	waktu	1
pelanggaran_waktu	pelanggaran	waktu	1
pelintas_waktu	pelintas	waktu	1
pem-batasan_waktu	pem-batasan	waktu	1
pema-kaian_waktu	pema-kaian	waktu	1
pemanfatan_waktu	pemanfatan	waktu	1
pembagian_waktu	pembagian	waktu	1
pembahasan_waktu	pembahasan	waktu	1
pembalik_waktu	pembalik	waktu	1
pembaruan_waktu	pembaruan	waktu	1
pembinaan_waktu	pembinaan	waktu	1
pembu-kaan_waktu	pembu-kaan	waktu	1
pemerintahan_waktu	pemerintahan	waktu	1
pemilihan_waktu	pemilihan	waktu	1
pemkot_waktu	pemkot	waktu	1
pemotongan_waktu	pemotongan	waktu	1
pemuda_waktu	pemuda	waktu	1
penagihan_waktu	penagihan	waktu	1
penalti_waktu	penalti	waktu	1
penanda_waktu	penanda	waktu	1
penangguhan_waktu	penangguhan	waktu	1
penasaran_waktu	penasaran	waktu	1
pencapaian_waktu	pencapaian	waktu	1
penculikan_waktu	penculikan	waktu	1
pendek-nya_waktu	pendek-nya	waktu	1
pendiri_waktu	pendiri	waktu	1
pene-rimaan_waktu	pene-rimaan	waktu	1
peng-awasan_waktu	peng-awasan	waktu	1
peng-unduran_waktu	peng-unduran	waktu	1
pengadil-an_waktu	pengadil-an	waktu	1
pengalaman_waktu	pengalaman	waktu	1
pengaruh_waktu	pengaruh	waktu	1
pengatur_waktu	pengatur	waktu	1
pengatur-an_waktu	pengatur-an	waktu	1
pengelolaan_waktu	pengelolaan	waktu	1
pengganti_waktu	pengganti	waktu	1
pengge-seran_waktu	pengge-seran	waktu	1
penghematan_waktu	penghematan	waktu	1
penghitung_waktu	penghitung	waktu	1
penghujung_waktu	penghujung	waktu	1
pengingat_waktu	pengingat	waktu	1
pengukur_waktu	pengukur	waktu	1
pengulur-uluran_waktu	pengulur-uluran	waktu	1
penilaian_waktu	penilaian	waktu	1
penjadwalan_waktu	penjadwalan	waktu	1
penjelajahan_waktu	penjelajahan	waktu	1
penjemputan_waktu	penjemputan	waktu	1
pentingnya_waktu	pentingnya	waktu	1
penutupan_waktu	penutupan	waktu	1
penyederhanaan_waktu	penyederhanaan	waktu	1
per_waktu	per	waktu	1
per-lu_waktu	per-lu	waktu	1
per-panjangan_waktu	per-panjangan	waktu	1
percaya_waktu	percaya	waktu	1
percepatan_waktu	percepatan	waktu	1
perge-seranya_waktu	perge-seranya	waktu	1
pergunakan_waktu	pergunakan	waktu	1
pergunakanlah_waktu	pergunakanlah	waktu	1
peringatan_waktu	peringatan	waktu	1
perizinan_waktu	perizinan	waktu	1
perizinannya_waktu	perizinannya	waktu	1
perkara_waktu	perkara	waktu	1
permasalahan_waktu	permasalahan	waktu	1
pernyataan_waktu	pernyataan	waktu	1
perpan-jangan_waktu	perpan-jangan	waktu	1
perpanjanga_waktu	perpanjanga	waktu	1
perpendekan_waktu	perpendekan	waktu	1
persis_waktu	persis	waktu	1
persisnya_waktu	persisnya	waktu	1
persoalan_waktu	persoalan	waktu	1
perspektif_waktu	perspektif	waktu	1
pertambahan_waktu	pertambahan	waktu	1
petugas_waktu	petugas	waktu	1
pikir_waktu	pikir	waktu	1
pilihlah_waktu	pilihlah	waktu	1
pilka-da_waktu	pilka-da	waktu	1
pleno_waktu	pleno	waktu	1
plus_waktu	plus	waktu	1
poin_waktu	poin	waktu	1
pola_waktu	pola	waktu	1
politik_waktu	politik	waktu	1
pos_waktu	pos	waktu	1
praktis_waktu	praktis	waktu	1
prediksi_waktu	prediksi	waktu	1
prestasi_waktu	prestasi	waktu	1
pri-badi_waktu	pri-badi	waktu	1
pro-testan_waktu	pro-testan	waktu	1
problem_waktu	problem	waktu	1
propinsi_waktu	propinsi	waktu	1
pu-kul_waktu	pu-kul	waktu	1
pula_waktu	pula	waktu	1
pulang_waktu	pulang	waktu	1
puluh_waktu	puluh	waktu	1
pulul_waktu	pulul	waktu	1
puncak_waktu	puncak	waktu	1
purna_waktu	purna	waktu	1
pusat_waktu	pusat	waktu	1
putih_waktu	putih	waktu	1
rabu_waktu	rabu	waktu	1
rahasia_waktu	rahasia	waktu	1
raihan_waktu	raihan	waktu	1
rangka_waktu	rangka	waktu	1
rapa_waktu	rapa	waktu	1
rasanya_waktu	rasanya	waktu	1
raskin_waktu	raskin	waktu	1
rata-rata_waktu	rata-rata	waktu	1
ratarata_waktu	ratarata	waktu	1
raya_waktu	raya	waktu	1
realisasi_waktu	realisasi	waktu	1
red_waktu	red	waktu	1
reguler_waktu	reguler	waktu	1
rekam_waktu	rekam	waktu	1
rekanan_waktu	rekanan	waktu	1
rektor_waktu	rektor	waktu	1
ren-tang_waktu	ren-tang	waktu	1
rencana_waktu	rencana	waktu	1
reses_waktu	reses	waktu	1
resmi_waktu	resmi	waktu	1
restorasi_waktu	restorasi	waktu	1
ribu_waktu	ribu	waktu	1
risiko_waktu	risiko	waktu	1
rusid_waktu	rusid	waktu	1
rute_waktu	rute	waktu	1
rutinitas_waktu	rutinitas	waktu	1
saatnya_waktu	saatnya	waktu	1
sadari_waktu	sadari	waktu	1
saham_waktu	saham	waktu	1
sahur_waktu	sahur	waktu	1
saksi_waktu	saksi	waktu	1
samping_waktu	samping	waktu	1
sana_waktu	sana	waktu	1
sang-ka_waktu	sang-ka	waktu	1
santai_waktu	santai	waktu	1
sapi_waktu	sapi	waktu	1
saputangan_waktu	saputangan	waktu	1
saran_waktu	saran	waktu	1
sasetan_waktu	sasetan	waktu	1
saudara_waktu	saudara	waktu	1
sayang_waktu	sayang	waktu	1
sayangnya_waktu	sayangnya	waktu	1
se-benarnya_waktu	se-benarnya	waktu	1
se-harusnya_waktu	se-harusnya	waktu	1
se-lang_waktu	se-lang	waktu	1
se-sungguhnya_waktu	se-sungguhnya	waktu	1
se-tiap_waktu	se-tiap	waktu	1
sebetulnya_waktu	sebetulnya	waktu	1
sebuah_waktu	sebuah	waktu	1
sedikitnya_waktu	sedikitnya	waktu	1
segencar_waktu	segencar	waktu	1
sei-ring_waktu	sei-ring	waktu	1
sejuk_waktu	sejuk	waktu	1
sekadar_waktu	sekadar	waktu	1
sekali-kali_waktu	sekali-kali	waktu	1
sekdes_waktu	sekdes	waktu	1
selain_waktu	selain	waktu	1
selekda_waktu	selekda	waktu	1
selesai_waktu	selesai	waktu	1
selo_waktu	selo	waktu	1
sem-patkan_waktu	sem-patkan	waktu	1
semalam_waktu	semalam	waktu	1
sembarang_waktu	sembarang	waktu	1
sempatkanlah_waktu	sempatkanlah	waktu	1
sempit_waktu	sempit	waktu	1
semuanya_waktu	semuanya	waktu	1
senangi_waktu	senangi	waktu	1
sepakat_waktu	sepakat	waktu	1
separah_waktu	separah	waktu	1
ser-ta_waktu	ser-ta	waktu	1
seragam_waktu	seragam	waktu	1
sesaat_waktu	sesaat	waktu	1
sesekali_waktu	sesekali	waktu	1
sesungguhnya_waktu	sesungguhnya	waktu	1
setidaknya_waktu	setidaknya	waktu	1
seting_waktu	seting	waktu	1
setting-an_waktu	setting-an	waktu	1
setujui_waktu	setujui	waktu	1
seusai_waktu	seusai	waktu	1
seusianya_waktu	seusianya	waktu	1
sholat_waktu	sholat	waktu	1
siap_waktu	siap	waktu	1
sidang_waktu	sidang	waktu	1
siensi_waktu	siensi	waktu	1
silat_waktu	silat	waktu	1
silatku_waktu	silatku	waktu	1
sini_waktu	sini	waktu	1
sisa-sisa_waktu	sisa-sisa	waktu	1
sisihkan_waktu	sisihkan	waktu	1
sistematika_waktu	sistematika	waktu	1
slot_waktu	slot	waktu	1
sms_waktu	sms	waktu	1
sosial_waktu	sosial	waktu	1
spesifik_waktu	spesifik	waktu	1
suka_waktu	suka	waktu	1
sulit_waktu	sulit	waktu	1
sumbangkan_waktu	sumbangkan	waktu	1
sumber_waktu	sumber	waktu	1
supporter_waktu	supporter	waktu	1
system_waktu	system	waktu	1
tabobale_waktu	tabobale	waktu	1
tahan_waktu	tahan	waktu	1
takage_waktu	takage	waktu	1
takaran_waktu	takaran	waktu	1
tako_waktu	tako	waktu	1
tali_waktu	tali	waktu	1
tam-bahan_waktu	tam-bahan	waktu	1
tanah_waktu	tanah	waktu	1
tanggapi_waktu	tanggapi	waktu	1
tarutama_waktu	tarutama	waktu	1
te-patnya_waktu	te-patnya	waktu	1
tegar_waktu	tegar	waktu	1
teng-gat_waktu	teng-gat	waktu	1
tenis_waktu	tenis	waktu	1
tentu_waktu	tentu	waktu	1
tentukan_waktu	tentukan	waktu	1
ter-pending_waktu	ter-pending	waktu	1
terbakar_waktu	terbakar	waktu	1
terbuka_waktu	terbuka	waktu	1
tercatat_waktu	tercatat	waktu	1
tercecer_waktu	tercecer	waktu	1
terdaftar_waktu	terdaftar	waktu	1
tergantung_waktu	tergantung	waktu	1
terima_waktu	terima	waktu	1
terindah_waktu	terindah	waktu	1
terkadang_waktu	terkadang	waktu	1
terkenal_waktu	terkenal	waktu	1
terkenang_waktu	terkenang	waktu	1
terkikis_waktu	terkikis	waktu	1
terkumpul_waktu	terkumpul	waktu	1
terlihat_waktu	terlihat	waktu	1
terpadu_waktu	terpadu	waktu	1
terpuruk_waktu	terpuruk	waktu	1
tersedia_waktu	tersedia	waktu	1
tersisa_waktu	tersisa	waktu	1
tertentu_waktu	tertentu	waktu	1
tes_waktu	tes	waktu	1
tetangga_waktu	tetangga	waktu	1
tetap_waktu	tetap	waktu	1
tetapkan_waktu	tetapkan	waktu	1
tiap_waktu	tiap	waktu	1
tiap-tiap_waktu	tiap-tiap	waktu	1
tiba-tiba_waktu	tiba-tiba	waktu	1
tibanya_waktu	tibanya	waktu	1
tim_waktu	tim	waktu	1
tinggal_waktu	tinggal	waktu	1
to-leransi_waktu	to-leransi	waktu	1
tu_waktu	tu	waktu	1
tuduhan_waktu	tuduhan	waktu	1
ubah_waktu	ubah	waktu	1
ujarnya_waktu	ujarnya	waktu	1
ukuran_waktu	ukuran	waktu	1
ulur_waktu	ulur	waktu	1
ummatku_waktu	ummatku	waktu	1
umumkan_waktu	umumkan	waktu	1
un-tuk_waktu	un-tuk	waktu	1
ungkapnya_waktu	ungkapnya	waktu	1
unik_waktu	unik	waktu	1
unit_waktu	unit	waktu	1
urainya_waktu	urainya	waktu	1
urgensi_waktu	urgensi	waktu	1
urine-nya_waktu	urine-nya	waktu	1
urutan_waktu	urutan	waktu	1
usia_waktu	usia	waktu	1
utarakan_waktu	utarakan	waktu	1
waktu_2x24jam	waktu	2x24jam	1
waktu_365-seperempat	waktu	365-seperempat	1
waktu_adaptasi	waktu	adaptasi	1
waktu_adegan-adegan	waktu	adegan-adegan	1
waktu_afdhal	waktu	afdhal	1
waktu_afdhol	waktu	afdhol	1
waktu_agak	waktu	agak	1
waktu_agama	waktu	agama	1
waktu_air	waktu	air	1
waktu_aja	waktu	aja	1
waktu_akad	waktu	akad	1
waktu_akademik	waktu	akademik	1
waktu_akhir-akhir	waktu	akhir-akhir	1
waktu_akibat	waktu	akibat	1
waktu_alergi	waktu	alergi	1
waktu_aliran	waktu	aliran	1
waktu_aman	waktu	aman	1
waktu_amatlah	waktu	amatlah	1
waktu_anak-anak	waktu	anak-anak	1
waktu_anggota	waktu	anggota	1
waktu_anjing	waktu	anjing	1
waktu_antar-anggota	waktu	antar-anggota	1
waktu_antrian	waktu	antrian	1
waktu_apa	waktu	apa	1
waktu_apakah	waktu	apakah	1
waktu_apel	waktu	apel	1
waktu_artinya	waktu	artinya	1
waktu_ataupun	waktu	ataupun	1
waktu_audiens	waktu	audiens	1
waktu_audited	waktu	audited	1
waktu_azan	waktu	azan	1
waktu_ba	waktu	ba	1
waktu_bagaimana	waktu	bagaimana	1
waktu_baginya	waktu	baginya	1
waktu_bah-wa	waktu	bah-wa	1
waktu_bahasa	waktu	bahasa	1
waktu_bakal	waktu	bakal	1
waktu_ban	waktu	ban	1
waktu_bantuan	waktu	bantuan	1
waktu_banyak-nya	waktu	banyak-nya	1
waktu_bapak	waktu	bapak	1
waktu_barang	waktu	barang	1
waktu_baru-baru	waktu	baru-baru	1
waktu_bayar	waktu	bayar	1
waktu_bayi	waktu	bayi	1
waktu_be	waktu	be	1
waktu_be-berapa	waktu	be-berapa	1
waktu_be-rangkat	waktu	be-rangkat	1
waktu_bebasnya	waktu	bebasnya	1
waktu_bebe-rapa	waktu	bebe-rapa	1
waktu_beber	waktu	beber	1
waktu_beda	waktu	beda	1
waktu_begitu	waktu	begitu	1
waktu_begitulah	waktu	begitulah	1
waktu_belanja	waktu	belanja	1
waktu_belasan	waktu	belasan	1
waktu_beli	waktu	beli	1
waktu_ben-di	waktu	ben-di	1
waktu_bepergian	waktu	bepergian	1
waktu_ber-arti	waktu	ber-arti	1
waktu_beradaptasi	waktu	beradaptasi	1
waktu_berakhir	waktu	berakhir	1
waktu_berangkat	waktu	berangkat	1
waktu_berangkat-pulang	waktu	berangkat-pulang	1
waktu_beranjak	waktu	beranjak	1
waktu_berbulan	waktu	berbulan	1
waktu_berbulan-bu-lan	waktu	berbulan-bu-lan	1
waktu_berbulan-bula	waktu	berbulan-bula	1
waktu_berdasarkan	waktu	berdasarkan	1
waktu_berdialog	waktu	berdialog	1
waktu_berduaan	waktu	berduaan	1
waktu_berduka	waktu	berduka	1
waktu_berdzikir	waktu	berdzikir	1
waktu_bergumul	waktu	bergumul	1
waktu_berhaji	waktu	berhaji	1
waktu_berharga	waktu	berharga	1
waktu_berharihari	waktu	berharihari	1
waktu_berhasil	waktu	berhasil	1
waktu_beriba-dah	waktu	beriba-dah	1
waktu_beribadah	waktu	beribadah	1
waktu_berikut-nya	waktu	berikut-nya	1
waktu_berisitirahat	waktu	berisitirahat	1
waktu_berjalan-jalan	waktu	berjalan-jalan	1
waktu_berjuang	waktu	berjuang	1
waktu_berkecimpung	waktu	berkecimpung	1
waktu_berkeliling	waktu	berkeliling	1
waktu_berkisar	waktu	berkisar	1
waktu_berlainan	waktu	berlainan	1
waktu_berlaku	waktu	berlaku	1
waktu_berlatih	waktu	berlatih	1
waktu_berlayar	waktu	berlayar	1
waktu_bernyanyi	waktu	bernyanyi	1
waktu_berpacaran	waktu	berpacaran	1
waktu_berperang	waktu	berperang	1
waktu_berpisah	waktu	berpisah	1
waktu_berpuasa	waktu	berpuasa	1
waktu_bersa-ma	waktu	bersa-ma	1
waktu_bersalin	waktu	bersalin	1
waktu_bersamanya	waktu	bersamanya	1
waktu_bersantap	waktu	bersantap	1
waktu_bersekolah	waktu	bersekolah	1
waktu_bersenang-senang	waktu	bersenang-senang	1
waktu_berta-hannya	waktu	berta-hannya	1
waktu_bertanding	waktu	bertanding	1
waktu_bertani	waktu	bertani	1
waktu_bertentangan	waktu	bertentangan	1
waktu_bertransformasi	waktu	bertransformasi	1
waktu_berubah	waktu	berubah	1
waktu_berusia	waktu	berusia	1
waktu_besar	waktu	besar	1
waktu_betul	waktu	betul	1
waktu_biar	waktu	biar	1
waktu_biaya	waktu	biaya	1
waktu_bikin	waktu	bikin	1
waktu_bintang	waktu	bintang	1
waktu_birokrasi	waktu	birokrasi	1
waktu_boneka	waktu	boneka	1
waktu_booking	waktu	booking	1
waktu_bu-kan	waktu	bu-kan	1
waktu_bu-lan	waktu	bu-lan	1
waktu_budget	waktu	budget	1
waktu_buffer	waktu	buffer	1
waktu_buku	waktu	buku	1
waktu_bupati	waktu	bupati	1
waktu_cahaya	waktu	cahaya	1
waktu_calon	waktu	calon	1
waktu_camatnya	waktu	camatnya	1
waktu_cari	waktu	cari	1
waktu_cenderung	waktu	cenderung	1
waktu_cicilannya	waktu	cicilannya	1
waktu_clearnya	waktu	clearnya	1
waktu_cu-kup	waktu	cu-kup	1
waktu_cuaca	waktu	cuaca	1
waktu_cuma	waktu	cuma	1
waktu_d	waktu	d	1
waktu_da-lam	waktu	da-lam	1
waktu_da-na	waktu	da-na	1
waktu_daftar	waktu	daftar	1
waktu_daging	waktu	daging	1
waktu_daripada	waktu	daripada	1
waktu_data	waktu	data	1
waktu_daya	waktu	daya	1
waktu_de-tik	waktu	de-tik	1
waktu_dead-line	waktu	dead-line	1
waktu_deadline	waktu	deadline	1
waktu_dekan	waktu	dekan	1
waktu_dekatlah	waktu	dekatlah	1
waktu_deklarasi	waktu	deklarasi	1
waktu_dektan	waktu	dektan	1
waktu_demisioner	waktu	demisioner	1
waktu_denga	waktu	denga	1
waktu_deteksi	waktu	deteksi	1
waktu_dfekat	waktu	dfekat	1
waktu_di-ambil	waktu	di-ambil	1
waktu_di-FPT	waktu	di-FPT	1
waktu_di-pending	waktu	di-pending	1
waktu_di-USG	waktu	di-USG	1
waktu_diajak	waktu	diajak	1
waktu_dialog	waktu	dialog	1
waktu_diangkut	waktu	diangkut	1
waktu_dianjurkan	waktu	dianjurkan	1
waktu_dibanding	waktu	dibanding	1
waktu_dibandingkan	waktu	dibandingkan	1
waktu_dibawa	waktu	dibawa	1
waktu_dibekukan	waktu	dibekukan	1
waktu_diberi	waktu	diberi	1
waktu_diberikan	waktu	diberikan	1
waktu_dibolehkannya	waktu	dibolehkannya	1
waktu_dibuka	waktu	dibuka	1
waktu_digebuki	waktu	digebuki	1
waktu_dihabiskan	waktu	dihabiskan	1
waktu_diharapkan	waktu	diharapkan	1
waktu_diinterogasi	waktu	diinterogasi	1
waktu_dijalan	waktu	dijalan	1
waktu_dikarenakan	waktu	dikarenakan	1
waktu_dikawatirkan	waktu	dikawatirkan	1
waktu_dikemudian	waktu	dikemudian	1
waktu_dikhawatirkan	waktu	dikhawatirkan	1
waktu_diklasemen	waktu	diklasemen	1
waktu_dikorbankan	waktu	dikorbankan	1
waktu_dikutip	waktu	dikutip	1
waktu_dilaksanakan	waktu	dilaksanakan	1
waktu_dilaku-kan	waktu	dilaku-kan	1
waktu_dilantik	waktu	dilantik	1
waktu_dilepas	waktu	dilepas	1
waktu_dilibur-kan	waktu	dilibur-kan	1
waktu_dimainkan	waktu	dimainkan	1
waktu_dimintai	waktu	dimintai	1
waktu_dinamika	waktu	dinamika	1
waktu_dinanti-nantikan	waktu	dinanti-nantikan	1
waktu_dinantikan	waktu	dinantikan	1
waktu_dinilainya	waktu	dinilainya	1
waktu_dipanggil	waktu	dipanggil	1
waktu_dipenghujung	waktu	dipenghujung	1
waktu_diperik-sa	waktu	diperik-sa	1
waktu_diperpanjang	waktu	diperpanjang	1
waktu_diproduksi	waktu	diproduksi	1
waktu_diputar	waktu	diputar	1
waktu_diri	waktu	diri	1
waktu_disalib	waktu	disalib	1
waktu_disesuaikan	waktu	disesuaikan	1
waktu_disiplin	waktu	disiplin	1
waktu_diskors	waktu	diskors	1
waktu_disuarakan	waktu	disuarakan	1
waktu_ditambah	waktu	ditambah	1
waktu_ditangkap	waktu	ditangkap	1
waktu_ditawari	waktu	ditawari	1
waktu_ditelusuri	waktu	ditelusuri	1
waktu_ditemukan	waktu	ditemukan	1
waktu_ditemukannya	waktu	ditemukannya	1
waktu_ditetapkan	waktu	ditetapkan	1
waktu_ditunda	waktu	ditunda	1
waktu_ditutup	waktu	ditutup	1
waktu_divisum	waktu	divisum	1
waktu_dkat	waktu	dkat	1
waktu_dong	waktu	dong	1
waktu_eceng	waktu	eceng	1
waktu_eksklusif	waktu	eksklusif	1
waktu_eksplorasi	waktu	eksplorasi	1
waktu_ekstrakurikuler	waktu	ekstrakurikuler	1
waktu_em	waktu	em	1
waktu_enambulan	waktu	enambulan	1
waktu_enan	waktu	enan	1
waktu_energi	waktu	energi	1
waktu_erupsi	waktu	erupsi	1
waktu_festival	waktu	festival	1
waktu_final	waktu	final	1
waktu_fixed	waktu	fixed	1
waktu_fleksibel	waktu	fleksibel	1
waktu_for	waktu	for	1
waktu_foto-foto	waktu	foto-foto	1
waktu_free	waktu	free	1
waktu_frekuensi	waktu	frekuensi	1
waktu_fungsi	waktu	fungsi	1
waktu_gaji	waktu	gaji	1
waktu_game	waktu	game	1
waktu_ganti	waktu	ganti	1
waktu_geladi	waktu	geladi	1
waktu_gencatan	waktu	gencatan	1
waktu_generasinya	waktu	generasinya	1
waktu_geologi	waktu	geologi	1
waktu_gereja	waktu	gereja	1
waktu_gerhana	waktu	gerhana	1
waktu_gitu	waktu	gitu	1
waktu_gol	waktu	gol	1
waktu_goyangan	waktu	goyangan	1
waktu_gubernur	waktu	gubernur	1
waktu_gugatan	waktu	gugatan	1
waktu_hamper	waktu	hamper	1
waktu_harapnya	waktu	harapnya	1
waktu_harganya	waktu	harganya	1
waktu_harta	waktu	harta	1
waktu_harus	waktu	harus	1
waktu_hewan-hewan	waktu	hewan-hewan	1
waktu_hiburan	waktu	hiburan	1
waktu_hidupmu	waktu	hidupmu	1
waktu_hubungi	waktu	hubungi	1
waktu_ibadah	waktu	ibadah	1
waktu_idealisme	waktu	idealisme	1
waktu_imbau	waktu	imbau	1
waktu_imbuh	waktu	imbuh	1
waktu_impornya	waktu	impornya	1
waktu_imsak	waktu	imsak	1
waktu_indekos	waktu	indekos	1
waktu_ingin	waktu	ingin	1
waktu_intensitas	waktu	intensitas	1
waktu_interaksi	waktu	interaksi	1
waktu_iPhone	waktu	iPhone	1
waktu_istirahatnya	waktu	istirahatnya	1
waktu_istrinya	waktu	istrinya	1
waktu_isya	waktu	isya	1
waktu_itu-itu	waktu	itu-itu	1
waktu_itu9	waktu	itu9	1
waktu_itulah	waktu	itulah	1
waktu_iyu	waktu	iyu	1
waktu_jabatan	waktu	jabatan	1
waktu_jadwal	waktu	jadwal	1
waktu_jamin	waktu	jamin	1
waktu_jang	waktu	jang	1
waktu_jangan	waktu	jangan	1
waktu_jangka	waktu	jangka	1
waktu_jeda	waktu	jeda	1
waktu_jelas-nya	waktu	jelas-nya	1
waktu_jem-batan	waktu	jem-batan	1
waktu_jembatan	waktu	jembatan	1
waktu_jendela	waktu	jendela	1
waktu_jua	waktu	jua	1
waktu_jumlahnya	waktu	jumlahnya	1
waktu_kadaluarsa	waktu	kadaluarsa	1
waktu_kali	waktu	kali	1
waktu_kalian	waktu	kalian	1
waktu_kamu	waktu	kamu	1
waktu_kantor	waktu	kantor	1
waktu_kapal	waktu	kapal	1
waktu_kapal-kapal	waktu	kapal-kapal	1
waktu_kapten	waktu	kapten	1
waktu_karir	waktu	karir	1
waktu_kata-kata	waktu	kata-kata	1
waktu_kawasan	waktu	kawasan	1
waktu_kaweng	waktu	kaweng	1
waktu_ke-pemimpinannya	waktu	ke-pemimpinannya	1
waktu_kebe-rangkatan	waktu	kebe-rangkatan	1
waktu_kebebasan	waktu	kebebasan	1
waktu_keberadaan	waktu	keberadaan	1
waktu_keberadaannya	waktu	keberadaannya	1
waktu_keberangkatannya	waktu	keberangkatannya	1
waktu_kebijakan	waktu	kebijakan	1
waktu_kebrutalan	waktu	kebrutalan	1
waktu_kebugaran	waktu	kebugaran	1
waktu_kebutuhan	waktu	kebutuhan	1
waktu_kecepatan	waktu	kecepatan	1
waktu_kedatangannya	waktu	kedatangannya	1
waktu_kegiatannya	waktu	kegiatannya	1
waktu_kelahiran	waktu	kelahiran	1
waktu_kelak	waktu	kelak	1
waktu_kelit	waktu	kelit	1
waktu_keluar	waktu	keluar	1
waktu_keluarga	waktu	keluarga	1
waktu_kelulusan	waktu	kelulusan	1
waktu_kematian	waktu	kematian	1
waktu_kenaikan	waktu	kenaikan	1
waktu_kenangnya	waktu	kenangnya	1
waktu_kendaraan	waktu	kendaraan	1
waktu_kendati	waktu	kendati	1
waktu_kepala	waktu	kepala	1
waktu_kepergian	waktu	kepergian	1
waktu_kepulangan	waktu	kepulangan	1
waktu_kerapian	waktu	kerapian	1
waktu_kerjanya	waktu	kerjanya	1
waktu_ketimbang	waktu	ketimbang	1
waktu_khususnya	waktu	khususnya	1
waktu_kian	waktu	kian	1
waktu_kira-kira	waktu	kira-kira	1
waktu_kisah	waktu	kisah	1
waktu_kisaran	waktu	kisaran	1
waktu_klimaks	waktu	klimaks	1
waktu_koa-lisi	waktu	koa-lisi	1
waktu_komputer	waktu	komputer	1
waktu_komunitas	waktu	komunitas	1
waktu_konsepsi	waktu	konsepsi	1
waktu_konsesi	waktu	konsesi	1
waktu_kontraknya	waktu	kontraknya	1
waktu_konversi	waktu	konversi	1
waktu_kopian	waktu	kopian	1
waktu_kosongnya	waktu	kosongnya	1
waktu_kreditnya	waktu	kreditnya	1
waktu_krisis	waktu	krisis	1
waktu_krusial	waktu	krusial	1
waktu_ku	waktu	ku	1
waktu_ku-rang	waktu	ku-rang	1
waktu_kualifikasi	waktu	kualifikasi	1
waktu_kualifikasinya	waktu	kualifikasinya	1
waktu_kun-jungan	waktu	kun-jungan	1
waktu_kunju-ngan	waktu	kunju-ngan	1
waktu_kunju-ngannya	waktu	kunju-ngannya	1
waktu_kunjung	waktu	kunjung	1
waktu_kunker	waktu	kunker	1
waktu_la-ma	waktu	la-ma	1
waktu_laga-laga	waktu	laga-laga	1
waktu_lah	waktu	lah	1
waktu_lahan	waktu	lahan	1
waktu_lahir	waktu	lahir	1
waktu_lakon	waktu	lakon	1
waktu_lalui	waktu	lalui	1
waktu_lampau	waktu	lampau	1
waktu_langsung	waktu	langsung	1
waktu_lanjut	waktu	lanjut	1
waktu_lantas	waktu	lantas	1
waktu_lapang	waktu	lapang	1
waktu_lapar	waktu	lapar	1
waktu_larinya	waktu	larinya	1
waktu_latiahn	waktu	latiahn	1
waktu_le	waktu	le	1
waktu_lebaran	waktu	lebaran	1
waktu_ledakan	waktu	ledakan	1
waktu_lewat	waktu	lewat	1
waktu_li-ma	waktu	li-ma	1
waktu_libuaran	waktu	libuaran	1
waktu_lingkungannya	waktu	lingkungannya	1
waktu_load	waktu	load	1
waktu_loading	waktu	loading	1
waktu_lokasi	waktu	lokasi	1
waktu_lomba	waktu	lomba	1
waktu_ma-ka	waktu	ma-ka	1
waktu_macet	waktu	macet	1
waktu_maghribnya	waktu	maghribnya	1
waktu_mahasiswa	waktu	mahasiswa	1
waktu_makanya	waktu	makanya	1
waktu_makna	waktu	makna	1
waktu_manu-sia	waktu	manu-sia	1
waktu_mar	waktu	mar	1
waktu_martabak	waktu	martabak	1
waktu_masa-masa	waktu	masa-masa	1
waktu_masuknya	waktu	masuknya	1
waktu_mati	waktu	mati	1
waktu_matur	waktu	matur	1
waktu_me-mimpin	waktu	me-mimpin	1
waktu_me-nemukan	waktu	me-nemukan	1
waktu_me-nyiapkan	waktu	me-nyiapkan	1
waktu_mela-kukan	waktu	mela-kukan	1
waktu_melaku-kan	waktu	melaku-kan	1
waktu_melempar	waktu	melempar	1
waktu_meli-hatnya	waktu	meli-hatnya	1
waktu_melihat-lihat	waktu	melihat-lihat	1
waktu_melimpah	waktu	melimpah	1
waktu_melukis	waktu	melukis	1
waktu_memanaskan	waktu	memanaskan	1
waktu_memandangi	waktu	memandangi	1
waktu_memasakan	waktu	memasakan	1
waktu_memasukkan	waktu	memasukkan	1
waktu_membagi	waktu	membagi	1
waktu_membahas	waktu	membahas	1
waktu_membersihkan	waktu	membersihkan	1
waktu_membicara-kan	waktu	membicara-kan	1
waktu_membuatnya	waktu	membuatnya	1
waktu_membuktikan	waktu	membuktikan	1
waktu_membuktikannya	waktu	membuktikannya	1
waktu_memburu	waktu	memburu	1
waktu_memerlukan	waktu	memerlukan	1
waktu_memesan	waktu	memesan	1
waktu_memikirkannya	waktu	memikirkannya	1
waktu_memimpin	waktu	memimpin	1
waktu_meminjam	waktu	meminjam	1
waktu_memotivasi	waktu	memotivasi	1
waktu_memparipuranakannya	waktu	memparipuranakannya	1
waktu_memperbanyak	waktu	memperbanyak	1
waktu_memulainya	waktu	memulainya	1
waktu_memulihkan	waktu	memulihkan	1
waktu_men-jadi	waktu	men-jadi	1
waktu_menabung	waktu	menabung	1
waktu_menabungnya	waktu	menabungnya	1
waktu_menaikkan	waktu	menaikkan	1
waktu_menanti	waktu	menanti	1
waktu_menciptakan	waktu	menciptakan	1
waktu_mencukupi	waktu	mencukupi	1
waktu_mendapat	waktu	mendapat	1
waktu_mendatangkan	waktu	mendatangkan	1
waktu_mendengar	waktu	mendengar	1
waktu_menduduki	waktu	menduduki	1
waktu_mene-mui	waktu	mene-mui	1
waktu_mene-tapkan	waktu	mene-tapkan	1
waktu_menekuni	waktu	menekuni	1
waktu_menemui	waktu	menemui	1
waktu_menetap	waktu	menetap	1
waktu_menetapkan	waktu	menetapkan	1
waktu_meng-alami	waktu	meng-alami	1
waktu_mengajar	waktu	mengajar	1
waktu_mengakses	waktu	mengakses	1
waktu_mengalami	waktu	mengalami	1
waktu_mengambil	waktu	mengambil	1
waktu_mengantarkan	waktu	mengantarkan	1
waktu_mengeluarkannya	waktu	mengeluarkannya	1
waktu_mengemudi	waktu	mengemudi	1
waktu_mengenai	waktu	mengenai	1
waktu_mengenyam	waktu	mengenyam	1
waktu_mengerjakan	waktu	mengerjakan	1
waktu_menggunakan	waktu	menggunakan	1
waktu_menghelat	waktu	menghelat	1
waktu_menghentikan	waktu	menghentikan	1
waktu_menginap	waktu	menginap	1
waktu_mengingatkan	waktu	mengingatkan	1
waktu_mengobrol	waktu	mengobrol	1
waktu_mengonsumsi	waktu	mengonsumsi	1
waktu_mengosongkan	waktu	mengosongkan	1
waktu_mengupas	waktu	mengupas	1
waktu_mengusir	waktu	mengusir	1
waktu_menikmati	waktu	menikmati	1
waktu_meningkat	waktu	meningkat	1
waktu_menitan	waktu	menitan	1
waktu_menjabat	waktu	menjabat	1
waktu_menjaga	waktu	menjaga	1
waktu_menjalankan	waktu	menjalankan	1
waktu_menjelaskan	waktu	menjelaskan	1
waktu_menun-jukkan	waktu	menun-jukkan	1
waktu_menunjukan	waktu	menunjukan	1
waktu_menurut	waktu	menurut	1
waktu_menyaksikan	waktu	menyaksikan	1
waktu_menyalurkan	waktu	menyalurkan	1
waktu_menyamakan	waktu	menyamakan	1
waktu_menyambangi	waktu	menyambangi	1
waktu_menyambut	waktu	menyambut	1
waktu_menyanyi	waktu	menyanyi	1
waktu_menyatakan	waktu	menyatakan	1
waktu_menyembelih	waktu	menyembelih	1
waktu_menyerang	waktu	menyerang	1
waktu_menyesuaikan	waktu	menyesuaikan	1
waktu_menyikat	waktu	menyikat	1
waktu_menyusui	waktu	menyusui	1
waktu_merangkap	waktu	merangkap	1
waktu_merangsang	waktu	merangsang	1
waktu_mereali-sasikan	waktu	mereali-sasikan	1
waktu_merekapun	waktu	merekapun	1
waktu_meskipun	waktu	meskipun	1
waktu_minggu-minggu	waktu	minggu-minggu	1
waktu_minimum	waktu	minimum	1
waktu_mobil-mobil	waktu	mobil-mobil	1
waktu_mogok	waktu	mogok	1
waktu_mortalitas	waktu	mortalitas	1
waktu_motor	waktu	motor	1
waktu_mulainya	waktu	mulainya	1
waktu_multiyears	waktu	multiyears	1
waktu_muncul	waktu	muncul	1
waktu_mundur	waktu	mundur	1
waktu_mungkin	waktu	mungkin	1
waktu_musiman	waktu	musiman	1
waktu_mutu	waktu	mutu	1
waktu_naiknya	waktu	naiknya	1
waktu_nantinya	waktu	nantinya	1
waktu_nanya	waktu	nanya	1
waktu_ne-gosiasi	waktu	ne-gosiasi	1
waktu_ngabuburit	waktu	ngabuburit	1
waktu_ngabuburit	waktu	ngabuburit	1
waktu_ngeyel	waktu	ngeyel	1
waktu_normalnya	waktu	normalnya	1
waktu_nostalgia	waktu	nostalgia	1
waktu_nya	waktu	nya	1
waktu_nyanyi	waktu	nyanyi	1
waktu_nyaris	waktu	nyaris	1
waktu_nyata	waktu	nyata	1
waktu_obligasi	waktu	obligasi	1
waktu_olahraga	waktu	olahraga	1
waktu_ongkos	waktu	ongkos	1
waktu_optimistinya	waktu	optimistinya	1
waktu_orbit	waktu	orbit	1
waktu_otomat	waktu	otomat	1
waktu_otomatis	waktu	otomatis	1
waktu_over	waktu	over	1
waktu_ovulasi	waktu	ovulasi	1
waktu_paceklik	waktu	paceklik	1
waktu_pameran	waktu	pameran	1
waktu_pandangan	waktu	pandangan	1
waktu_pangan	waktu	pangan	1
waktu_panggilan	waktu	panggilan	1
waktu_pangkat	waktu	pangkat	1
waktu_pantai	waktu	pantai	1
waktu_parpol	waktu	parpol	1
waktu_pas	waktu	pas	1
waktu_pascakemerdekaan	waktu	pascakemerdekaan	1
waktu_patuhi	waktu	patuhi	1
waktu_pe-masukan	waktu	pe-masukan	1
waktu_pe-nandatanganan	waktu	pe-nandatanganan	1
waktu_pe-nangkapan	waktu	pe-nangkapan	1
waktu_pe-ngambilan	waktu	pe-ngambilan	1
waktu_pe-ngembalikan	waktu	pe-ngembalikan	1
waktu_pe-ngumu-man	waktu	pe-ngumu-man	1
waktu_pe-nyaluran	waktu	pe-nyaluran	1
waktu_pe-nyampaian	waktu	pe-nyampaian	1
waktu_pe-nyelesaian	waktu	pe-nyelesaian	1
waktu_pegawai	waktu	pegawai	1
waktu_pekerjanya	waktu	pekerjanya	1
waktu_pela-yanan	waktu	pela-yanan	1
waktu_pelajaran	waktu	pelajaran	1
waktu_pelaksa-naannya	waktu	pelaksa-naannya	1
waktu_pelaksaan	waktu	pelaksaan	1
waktu_pelaksanaanya	waktu	pelaksanaanya	1
waktu_pelaksanan	waktu	pelaksanan	1
waktu_pelanggan	waktu	pelanggan	1
waktu_pelantikannya	waktu	pelantikannya	1
waktu_pelari	waktu	pelari	1
waktu_pelatih	waktu	pelatih	1
waktu_peledakan	waktu	peledakan	1
waktu_pelelangan	waktu	pelelangan	1
waktu_pelimpa-han	waktu	pelimpa-han	1
waktu_pelimpahan	waktu	pelimpahan	1
waktu_pelunaaan	waktu	pelunaaan	1
waktu_pem-bahasan	waktu	pem-bahasan	1
waktu_pem-bentukan	waktu	pem-bentukan	1
waktu_pem-bukaan	waktu	pem-bukaan	1
waktu_pema-kaman	waktu	pema-kaman	1
waktu_pema-sukan	waktu	pema-sukan	1
waktu_pemadaman	waktu	pemadaman	1
waktu_pemadamannya	waktu	pemadamannya	1
waktu_pemanfaatan	waktu	pemanfaatan	1
waktu_pemasakannya	waktu	pemasakannya	1
waktu_pemasaran	waktu	pemasaran	1
waktu_pemasukannya	waktu	pemasukannya	1
waktu_pemba-giannya	waktu	pemba-giannya	1
waktu_pemba-yaran	waktu	pemba-yaran	1
waktu_pembagian	waktu	pembagian	1
waktu_pembaha-sannya	waktu	pembaha-sannya	1
waktu_pembahasannya	waktu	pembahasannya	1
waktu_pembangunannya	waktu	pembangunannya	1
waktu_pembatasnya	waktu	pembatasnya	1
waktu_pembaya-ran	waktu	pembaya-ran	1
waktu_pembayar-annya	waktu	pembayar-annya	1
waktu_pembebasan	waktu	pembebasan	1
waktu_pembedahan	waktu	pembedahan	1
waktu_pembekalan	waktu	pembekalan	1
waktu_pembelian	waktu	pembelian	1
waktu_pember-lakukan	waktu	pember-lakukan	1
waktu_pemberangkatan	waktu	pemberangkatan	1
waktu_pemberontakan	waktu	pemberontakan	1
waktu_pembersihan	waktu	pembersihan	1
waktu_pembiayaan	waktu	pembiayaan	1
waktu_pembinaan	waktu	pembinaan	1
waktu_pemboman	waktu	pemboman	1
waktu_pemecatan	waktu	pemecatan	1
waktu_pemeliharaan	waktu	pemeliharaan	1
waktu_pemerik-saannya	waktu	pemerik-saannya	1
waktu_pemerintahan	waktu	pemerintahan	1
waktu_pemesanan	waktu	pemesanan	1
waktu_pemilu	waktu	pemilu	1
waktu_pemindahan	waktu	pemindahan	1
waktu_peminjaman	waktu	peminjaman	1
waktu_pemkab	waktu	pemkab	1
waktu_pemkot	waktu	pemkot	1
waktu_pemrosesan	waktu	pemrosesan	1
waktu_pemuatan	waktu	pemuatan	1
waktu_penahanan	waktu	penahanan	1
waktu_penampilan	waktu	penampilan	1
waktu_penampungan	waktu	penampungan	1
waktu_penandata-nganan	waktu	penandata-nganan	1
waktu_penanganan	waktu	penanganan	1
waktu_pencapaian	waktu	pencapaian	1
waktu_pencarian	waktu	pencarian	1
waktu_pendafta-ran	waktu	pendafta-ran	1
waktu_pendaftarannya	waktu	pendaftarannya	1
waktu_pendampingan	waktu	pendampingan	1
waktu_penderitaan	waktu	penderitaan	1
waktu_pendeta	waktu	pendeta	1
waktu_penempatan	waktu	penempatan	1
waktu_penentuan	waktu	penentuan	1
waktu_penertiban	waktu	penertiban	1
waktu_penertibannya	waktu	penertibannya	1
waktu_peng-hentian	waktu	peng-hentian	1
waktu_penga-juan	waktu	penga-juan	1
waktu_penga-rahan	waktu	penga-rahan	1
waktu_pengajaran	waktu	pengajaran	1
waktu_pengam-bilan	waktu	pengam-bilan	1
waktu_pengamatan	waktu	pengamatan	1
waktu_pengangkatan	waktu	pengangkatan	1
waktu_pengaruh	waktu	pengaruh	1
waktu_pengaruh-nya	waktu	pengaruh-nya	1
waktu_pengasuh	waktu	pengasuh	1
waktu_pengatu-ran	waktu	pengatu-ran	1
waktu_pengelolaannya	waktu	pengelolaannya	1
waktu_pengem-balian	waktu	pengem-balian	1
waktu_pengem-balikan	waktu	pengem-balikan	1
waktu_pengembangan	waktu	pengembangan	1
waktu_pengesahan	waktu	pengesahan	1
waktu_pengesahannya	waktu	pengesahannya	1
waktu_penggarapannya	waktu	penggarapannya	1
waktu_penggeledahan	waktu	penggeledahan	1
waktu_penggemar	waktu	penggemar	1
waktu_pengi-riman	waktu	pengi-riman	1
waktu_pengibaran	waktu	pengibaran	1
waktu_pengikatan	waktu	pengikatan	1
waktu_pengingat	waktu	pengingat	1
waktu_pengirimannya	waktu	pengirimannya	1
waktu_pengisian	waktu	pengisian	1
waktu_pengolahan	waktu	pengolahan	1
waktu_pengosongan	waktu	pengosongan	1
waktu_pengu-buran	waktu	pengu-buran	1
waktu_pengu-sulan	waktu	pengu-sulan	1
waktu_pengucuran	waktu	pengucuran	1
waktu_pengumpulan	waktu	pengumpulan	1
waktu_pengumumannya	waktu	pengumumannya	1
waktu_pengusulan	waktu	pengusulan	1
waktu_pensiunnya	waktu	pensiunnya	1
waktu_pentahbisan	waktu	pentahbisan	1
waktu_penuh	waktu	penuh	1
waktu_penukaran	waktu	penukaran	1
waktu_penulis	waktu	penulis	1
waktu_penundaan	waktu	penundaan	1
waktu_penyajian	waktu	penyajian	1
waktu_penyalur-an	waktu	penyalur-an	1
waktu_penyambungan	waktu	penyambungan	1
waktu_penyampaikan	waktu	penyampaikan	1
waktu_penyanyi	waktu	penyanyi	1
waktu_penye-rahan	waktu	penye-rahan	1
waktu_penye-suaian	waktu	penye-suaian	1
waktu_penyebarannya	waktu	penyebarannya	1
waktu_penyeberangan	waktu	penyeberangan	1
waktu_penyelanggaraan	waktu	penyelanggaraan	1
waktu_penyeleng-garaan	waktu	penyeleng-garaan	1
waktu_penyelesaiannya	waktu	penyelesaiannya	1
waktu_penyembuhannya	waktu	penyembuhannya	1
waktu_penyesuaian	waktu	penyesuaian	1
waktu_penyewaan	waktu	penyewaan	1
waktu_penyiapan	waktu	penyiapan	1
waktu_penyidikan	waktu	penyidikan	1
waktu_penyusunan	waktu	penyusunan	1
waktu_per	waktu	per	1
waktu_per-baikan	waktu	per-baikan	1
waktu_per-lindungan	waktu	per-lindungan	1
waktu_per-sisnya	waktu	per-sisnya	1
waktu_pera-saan	waktu	pera-saan	1
waktu_peradaban	waktu	peradaban	1
waktu_perbaikan	waktu	perbaikan	1
waktu_percobaan	waktu	percobaan	1
waktu_perekrutan	waktu	perekrutan	1
waktu_perencanaan	waktu	perencanaan	1
waktu_pergantian	waktu	pergantian	1
waktu_perhitungan	waktu	perhitungan	1
waktu_perjamuan	waktu	perjamuan	1
waktu_perjuangan	waktu	perjuangan	1
waktu_perkara	waktu	perkara	1
waktu_perkuliahan	waktu	perkuliahan	1
waktu_permainan	waktu	permainan	1
waktu_perpanjangan	waktu	perpanjangan	1
waktu_persiapannya	waktu	persiapannya	1
waktu_persida-ngan	waktu	persida-ngan	1
waktu_persidangan	waktu	persidangan	1
waktu_persis	waktu	persis	1
waktu_persisnya	waktu	persisnya	1
waktu_pertan-dingan	waktu	pertan-dingan	1
waktu_pertand	waktu	pertand	1
waktu_pertempuran	waktu	pertempuran	1
waktu_pertengahan	waktu	pertengahan	1
waktu_perundangan	waktu	perundangan	1
waktu_perundingan	waktu	perundingan	1
waktu_perusahaan	waktu	perusahaan	1
waktu_pesta	waktu	pesta	1
waktu_peti	waktu	peti	1
waktu_pi-kirnya	waktu	pi-kirnya	1
waktu_pidato	waktu	pidato	1
waktu_pihak	waktu	pihak	1
waktu_pilpres	waktu	pilpres	1
waktu_pindah	waktu	pindah	1
waktu_pisah	waktu	pisah	1
waktu_pleno	waktu	pleno	1
waktu_port	waktu	port	1
waktu_praktik	waktu	praktik	1
waktu_presentase	waktu	presentase	1
waktu_presentasi	waktu	presentasi	1
waktu_prestasi	waktu	prestasi	1
waktu_primordial	waktu	primordial	1
waktu_proposal	waktu	proposal	1
waktu_prosedural	waktu	prosedural	1
waktu_prosesi	waktu	prosesi	1
waktu_publik	waktu	publik	1
waktu_pula	waktu	pula	1
waktu_pulangnya	waktu	pulangnya	1
waktu_pungkas	waktu	pungkas	1
waktu_punya	waktu	punya	1
waktu_rakyatnya	waktu	rakyatnya	1
waktu_rantai	waktu	rantai	1
waktu_rasa	waktu	rasa	1
waktu_rawan	waktu	rawan	1
waktu_razia	waktu	razia	1
waktu_re-latif	waktu	re-latif	1
waktu_realisasinya	waktu	realisasinya	1
waktu_recovery	waktu	recovery	1
waktu_refreshing	waktu	refreshing	1
waktu_registrasi	waktu	registrasi	1
waktu_rekahan	waktu	rekahan	1
waktu_rekan	waktu	rekan	1
waktu_rekor	waktu	rekor	1
waktu_relative	waktu	relative	1
waktu_rencana	waktu	rencana	1
waktu_reses	waktu	reses	1
waktu_respons	waktu	respons	1
waktu_rilisnya	waktu	rilisnya	1
waktu_riset	waktu	riset	1
waktu_roda	waktu	roda	1
waktu_rolling	waktu	rolling	1
waktu_rumahnja	waktu	rumahnja	1
waktu_sa-kit	waktu	sa-kit	1
waktu_sa-ma	waktu	sa-ma	1
waktu_sakit	waktu	sakit	1
waktu_sam-pai	waktu	sam-pai	1
waktu_sam-pe	waktu	sam-pe	1
waktu_sama-sama	waktu	sama-sama	1
waktu_sampAI	waktu	sampAI	1
waktu_sampe	waktu	sampe	1
waktu_sandar	waktu	sandar	1
waktu_sangatlah	waktu	sangatlah	1
waktu_sangkakala	waktu	sangkakala	1
waktu_sarapan	waktu	sarapan	1
waktu_se-benarnya	waktu	se-benarnya	1
waktu_se-cepatnya	waktu	se-cepatnya	1
waktu_se-hari-hari	waktu	se-hari-hari	1
waktu_se-harian	waktu	se-harian	1
waktu_se-lang	waktu	se-lang	1
waktu_se-leksi	waktu	se-leksi	1
waktu_se-makin	waktu	se-makin	1
waktu_se-malam	waktu	se-malam	1
waktu_sebagaimana	waktu	sebagaimana	1
waktu_sebaik-baiknya	waktu	sebaik-baiknya	1
waktu_sebaik-nya	waktu	sebaik-nya	1
waktu_sebaiknya	waktu	sebaiknya	1
waktu_sebanyak	waktu	sebanyak	1
waktu_sebe-lum	waktu	sebe-lum	1
waktu_sebenarnya	waktu	sebenarnya	1
waktu_sebesar	waktu	sebesar	1
waktu_sebesar-besarnya	waktu	sebesar-besarnya	1
waktu_sebutan	waktu	sebutan	1
waktu_secepat	waktu	secepat	1
waktu_secukupnya	waktu	secukupnya	1
waktu_sedetikpun	waktu	sedetikpun	1
waktu_sedikit-dikitnya	waktu	sedikit-dikitnya	1
waktu_seduh	waktu	seduh	1
waktu_seharusnya	waktu	seharusnya	1
waktu_sehatmu	waktu	sehatmu	1
waktu_sehubungan	waktu	sehubungan	1
waktu_seiring	waktu	seiring	1
waktu_sejak	waktu	sejak	1
waktu_sejam	waktu	sejam	1
waktu_sejarah	waktu	sejarah	1
waktu_sekadar	waktu	sekadar	1
waktu_sekali	waktu	sekali	1
waktu_sekaligus	waktu	sekaligus	1
waktu_sekejab	waktu	sekejab	1
waktu_sekelompok	waktu	sekelompok	1
waktu_seketika	waktu	seketika	1
waktu_sekolah	waktu	sekolah	1
waktu_sekolahnya	waktu	sekolahnya	1
waktu_sekurang-kurangnya	waktu	sekurang-kurangnya	1
waktu_sela-ma	waktu	sela-ma	1
waktu_selagi	waktu	selagi	1
waktu_selain	waktu	selain	1
waktu_selam-bat-lambatnya	waktu	selam-bat-lambatnya	1
waktu_selambatnya	waktu	selambatnya	1
waktu_selanjutnya	waktu	selanjutnya	1
waktu_selebar-lebarnya	waktu	selebar-lebarnya	1
waktu_selekas2nja	waktu	selekas2nja	1
waktu_selepas	waktu	selepas	1
waktu_selesai	waktu	selesai	1
waktu_selesainya	waktu	selesainya	1
waktu_seluruh	waktu	seluruh	1
waktu_semaksimal	waktu	semaksimal	1
waktu_semalaman	waktu	semalaman	1
waktu_sementara	waktu	sementara	1
waktu_semester	waktu	semester	1
waktu_sempurna	waktu	sempurna	1
waktu_seng-gangnya	waktu	seng-gangnya	1
waktu_sengang	waktu	sengang	1
waktu_senja	waktu	senja	1
waktu_sensitif	waktu	sensitif	1
waktu_sensus	waktu	sensus	1
waktu_seolah	waktu	seolah	1
waktu_sepenuhnya	waktu	sepenuhnya	1
waktu_servis	waktu	servis	1
waktu_sesaat	waktu	sesaat	1
waktu_sesegera	waktu	sesegera	1
waktu_sesi	waktu	sesi	1
waktu_sesingkat	waktu	sesingkat	1
waktu_seta-hun	waktu	seta-hun	1
waktu_setempt	waktu	setempt	1
waktu_seumur	waktu	seumur	1
waktu_shalatnya	waktu	shalatnya	1
waktu_shift	waktu	shift	1
waktu_sia-sia	waktu	sia-sia	1
waktu_siaga	waktu	siaga	1
waktu_siangnya	waktu	siangnya	1
waktu_siap	waktu	siap	1
waktu_siapa	waktu	siapa	1
waktu_sifatnya	waktu	sifatnya	1
waktu_sihir	waktu	sihir	1
waktu_sing-kat	waktu	sing-kat	1
waktu_sistem	waktu	sistem	1
waktu_siswa	waktu	siswa	1
waktu_somo	waktu	somo	1
waktu_sorga	waktu	sorga	1
waktu_sosialisasi	waktu	sosialisasi	1
waktu_sosialisasinya	waktu	sosialisasinya	1
waktu_sprinter	waktu	sprinter	1
waktu_sQuba	waktu	sQuba	1
waktu_start	waktu	start	1
waktu_struggle	waktu	struggle	1
waktu_su-dah	waktu	su-dah	1
waktu_su-paya	waktu	su-paya	1
waktu_suami	waktu	suami	1
waktu_sujudnya	waktu	sujudnya	1
waktu_supaya	waktu	supaya	1
waktu_survei	waktu	survei	1
waktu_survival	waktu	survival	1
waktu_syuruk	waktu	syuruk	1
waktu_syuting	waktu	syuting	1
waktu_ta-hun	waktu	ta-hun	1
waktu_tadi	waktu	tadi	1
waktu_tahap	waktu	tahap	1
waktu_tahapan-tahapan	waktu	tahapan-tahapan	1
waktu_tahu	waktu	tahu	1
waktu_takkan	waktu	takkan	1
waktu_taman	waktu	taman	1
waktu_tar	waktu	tar	1
waktu_tausiah	waktu	tausiah	1
waktu_tawaf	waktu	tawaf	1
waktu_tayang	waktu	tayang	1
waktu_tayang-kan	waktu	tayang-kan	1
waktu_te-rangnya	waktu	te-rangnya	1
waktu_tebang	waktu	tebang	1
waktu_tegasnya	waktu	tegasnya	1
waktu_teknologi	waktu	teknologi	1
waktu_tem-puh	waktu	tem-puh	1
waktu_tempu	waktu	tempu	1
waktu_tendangan	waktu	tendangan	1
waktu_tender	waktu	tender	1
waktu_tenggelamnya	waktu	tenggelamnya	1
waktu_tenor	waktu	tenor	1
waktu_tentunya	waktu	tentunya	1
waktu_ter-akhir	waktu	ter-akhir	1
waktu_ter-buru-buru	waktu	ter-buru-buru	1
waktu_terangnya	waktu	terangnya	1
waktu_terbangnya	waktu	terbangnya	1
waktu_terbitnya	waktu	terbitnya	1
waktu_terburu-buru	waktu	terburu-buru	1
waktu_tercepatnya	waktu	tercepatnya	1
waktu_terdekat	waktu	terdekat	1
waktu_terecepatnya	waktu	terecepatnya	1
waktu_tergantung	waktu	tergantung	1
waktu_terjadinya	waktu	terjadinya	1
waktu_terkecil	waktu	terkecil	1
waktu_terlelap	waktu	terlelap	1
waktu_terlewat	waktu	terlewat	1
waktu_terlihat	waktu	terlihat	1
waktu_termasuk	waktu	termasuk	1
waktu_terpanjang	waktu	terpanjang	1
waktu_terpisah	waktu	terpisah	1
waktu_terse-but	waktu	terse-but	1
waktu_tersulit	waktu	tersulit	1
waktu_tertahan	waktu	tertahan	1
waktu_tertangkaplah	waktu	tertangkaplah	1
waktu_tes	waktu	tes	1
waktu_tiap	waktu	tiap	1
waktu_tiga-empat	waktu	tiga-empat	1
waktu_timbul	waktu	timbul	1
waktu_time	waktu	time	1
waktu_tinggalkan	waktu	tinggalkan	1
waktu_tiwul	waktu	tiwul	1
waktu_toko	waktu	toko	1
waktu_total	waktu	total	1
waktu_transisi	waktu	transisi	1
waktu_transit	waktu	transit	1
waktu_truk	waktu	truk	1
waktu_tua	waktu	tua	1
waktu_tugas	waktu	tugas	1
waktu_tuh	waktu	tuh	1
waktu_tun-tutan	waktu	tun-tutan	1
waktu_tur	waktu	tur	1
waktu_ujang	waktu	ujang	1
waktu_ujicoba	waktu	ujicoba	1
waktu_ulang	waktu	ulang	1
waktu_umur	waktu	umur	1
waktu_umurnya	waktu	umurnya	1
waktu_unduh	waktu	unduh	1
waktu_unggah	waktu	unggah	1
waktu_unit	waktu	unit	1
waktu_unruk	waktu	unruk	1
waktu_upacara	waktu	upacara	1
waktu_upayakan	waktu	upayakan	1
waktu_upload	waktu	upload	1
waktu_urainya	waktu	urainya	1
waktu_urutan	waktu	urutan	1
waktu_usia	waktu	usia	1
waktu_utusan	waktu	utusan	1
waktu_validasi	waktu	validasi	1
waktu_virus	waktu	virus	1
waktu_vote	waktu	vote	1
waktu_wagub	waktu	wagub	1
waktu_waktu	waktu	waktu	1
waktu_walaupun	waktu	walaupun	1
waktu_wanita	waktu	wanita	1
waktu_war-ga	waktu	war-ga	1
waktu_wawancara	waktu	wawancara	1
waktu_webbing	waktu	webbing	1
waktu_week	waktu	week	1
waktu_weekend	waktu	weekend	1
waktu_yg	waktu	yg	1
waktu_yuk	waktu	yuk	1
waktu_zumba	waktu	zumba	1
waktu-ke_waktu	waktu-ke	waktu	1
walikota_waktu	walikota	waktu	1
yah_waktu	yah	waktu	1
year_waktu	year	waktu	1
