ngram	w1	w2	n
di_zaman	di	zaman	137
pada_zaman	pada	zaman	109
sejak_zaman	sejak	zaman	82
perkembangan_zaman	perkembangan	zaman	81
zaman_dulu	zaman	dulu	66
zaman_sekarang	zaman	sekarang	60
zaman_dahulu	zaman	dahulu	47
zaman_yang	zaman	yang	39
dari_zaman	dari	zaman	34
zaman_itu	zaman	itu	27
zaman_dan	zaman	dan	24
perubahan_zaman	perubahan	zaman	20
zaman_penjajahan	zaman	penjajahan	19
akhir_zaman	akhir	zaman	18
zaman_modern	zaman	modern	18
ke_zaman	ke	zaman	16
kemajuan_zaman	kemajuan	zaman	14
zaman_kolonial	zaman	kolonial	14
zaman_orde	zaman	orde	12
zaman_ini	zaman	ini	11
peninggalan_zaman	peninggalan	zaman	10
ketinggalan_zaman	ketinggalan	zaman	9
dengan_zaman	dengan	zaman	8
sepanjang_zaman	sepanjang	zaman	7
tantangan_zaman	tantangan	zaman	7
zaman_batu	zaman	batu	7
zaman_kerajaan	zaman	kerajaan	7
zaman_nenek	zaman	nenek	7
zaman_perang	zaman	perang	7
zaman_tersebut	zaman	tersebut	7
muda_zaman	muda	zaman	6
oleh_zaman	oleh	zaman	6
tuntutan_zaman	tuntutan	zaman	6
zaman_baru	zaman	baru	6
zaman_ketika	zaman	ketika	6
zaman_pemerintahan	zaman	pemerintahan	6
zaman_saya	zaman	saya	6
berkembangnya_zaman	berkembangnya	zaman	5
dinamika_zaman	dinamika	zaman	5
mengikuti_zaman	mengikuti	zaman	5
pemuda_zaman	pemuda	zaman	5
zaman_baheula	zaman	baheula	5
zaman_dengan	zaman	dengan	5
zaman_keemasan	zaman	keemasan	5
zaman_perjuangan	zaman	perjuangan	5
zaman_prasejarah	zaman	prasejarah	5
zaman_saat	zaman	saat	5
ketika_zaman	ketika	zaman	4
masyarakat_zaman	masyarakat	zaman	4
sebelum_zaman	sebelum	zaman	4
setiap_zaman	setiap	zaman	4
zaman_di	zaman	di	4
zaman_ke	zaman	ke	4
zaman_kemerdekaan	zaman	kemerdekaan	4
zaman_kini	zaman	kini	4
zaman_kita	zaman	kita	4
zaman_reformasi	zaman	reformasi	4
zaman_semakin	zaman	semakin	4
anak_zaman	anak	zaman	3
benda-benda_zaman	benda-benda	zaman	3
dan_zaman	dan	zaman	3
daripada_zaman	daripada	zaman	3
gempuran_zaman	gempuran	zaman	3
hingga_zaman	hingga	zaman	3
itu_zaman	itu	zaman	3
kebutuhan_zaman	kebutuhan	zaman	3
tanda-tanda_zaman	tanda-tanda	zaman	3
tergerus_zaman	tergerus	zaman	3
zaman_jahiliyah	zaman	jahiliyah	3
zaman_kata	zaman	kata	3
zaman_kepemimpinan	zaman	kepemimpinan	3
zaman_kuno	zaman	kuno	3
zaman_memang	zaman	memang	3
zaman_nabi	zaman	nabi	3
zaman_purba	zaman	purba	3
zaman_raja-raja	zaman	raja-raja	3
zaman_sekolah	zaman	sekolah	3
zaman_sudah	zaman	sudah	3
anak-anak_zaman	anak-anak	zaman	2
atau_zaman	atau	zaman	2
bukan_zaman	bukan	zaman	2
dimakan_zaman	dimakan	zaman	2
ditelan_zaman	ditelan	zaman	2
fase_zaman	fase	zaman	2
karena_zaman	karena	zaman	2
keramik_zaman	keramik	zaman	2
khas_zaman	khas	zaman	2
mengingat_zaman	mengingat	zaman	2
modern_zaman	modern	zaman	2
penanda_zaman	penanda	zaman	2
perempuan_zaman	perempuan	zaman	2
perkemba-ngan_zaman	perkemba-ngan	zaman	2
saat_zaman	saat	zaman	2
sampai_zaman	sampai	zaman	2
se-jak_zaman	se-jak	zaman	2
sejarah_zaman	sejarah	zaman	2
semangat_zaman	semangat	zaman	2
seperti_zaman	seperti	zaman	2
sesuai_zaman	sesuai	zaman	2
tawaran_zaman	tawaran	zaman	2
termakan_zaman	termakan	zaman	2
tidak_zaman	tidak	zaman	2
uang_zaman	uang	zaman	2
waktu_zaman	waktu	zaman	2
zaman_adalah	zaman	adalah	2
zaman_digital	zaman	digital	2
zaman_edan	zaman	edan	2
zaman_katanya	zaman	katanya	2
zaman_kejayaan	zaman	kejayaan	2
zaman_lagi	zaman	lagi	2
zaman_mereka	zaman	mereka	2
zaman_model	zaman	model	2
zaman_normal	zaman	normal	2
zaman_nyatanya	zaman	nyatanya	2
zaman_para	zaman	para	2
zaman_pergerakan	zaman	pergerakan	2
zaman_sahabat	zaman	sahabat	2
zaman_sama	zaman	sama	2
zaman_se-karang	zaman	se-karang	2
zaman_sebelum	zaman	sebelum	2
zaman_serba	zaman	serba	2
zaman_tak	zaman	tak	2
zaman_ternyata	zaman	ternyata	2
zaman_terus	zaman	terus	2
zaman_ujar	zaman	ujar	2
2016Pada_zaman	2016Pada	zaman	1
ada_zaman	ada	zaman	1
ada-lah_zaman	ada-lah	zaman	1
adalah_zaman	adalah	zaman	1
aliran_zaman	aliran	zaman	1
apalagi_zaman	apalagi	zaman	1
awal_zaman	awal	zaman	1
bahasa_zaman	bahasa	zaman	1
bahkan_zaman	bahkan	zaman	1
bahwa_zaman	bahwa	zaman	1
bangsa_zaman	bangsa	zaman	1
batik_zaman	batik	zaman	1
batu_zaman	batu	zaman	1
belakang_zaman	belakang	zaman	1
berarsitektur_zaman	berarsitektur	zaman	1
berbagai_zaman	berbagai	zaman	1
bergesernya_zaman	bergesernya	zaman	1
berjalannya_zaman	berjalannya	zaman	1
berkembang_zaman	berkembang	zaman	1
berkembangannya_zaman	berkembangannya	zaman	1
berkurang_zaman	berkurang	zaman	1
bocah_zaman	bocah	zaman	1
budaya_zaman	budaya	zaman	1
cerita_zaman	cerita	zaman	1
cinta_zaman	cinta	zaman	1
dalam_zaman	dalam	zaman	1
dangdut_zaman	dangdut	zaman	1
datangnya_zaman	datangnya	zaman	1
desa_zaman	desa	zaman	1
dibanding_zaman	dibanding	zaman	1
digital_zaman	digital	zaman	1
dilakukan_zaman	dilakukan	zaman	1
ditenggelamkan_zaman	ditenggelamkan	zaman	1
diterapkan_zaman	diterapkan	zaman	1
ditinggalkan_zaman	ditinggalkan	zaman	1
dugem_zaman	dugem	zaman	1
enak_zaman	enak	zaman	1
entah_zaman	entah	zaman	1
fantasi_zaman	fantasi	zaman	1
fatwa_zaman	fatwa	zaman	1
faze_zaman	faze	zaman	1
fenomena_zaman	fenomena	zaman	1
film_zaman	film	zaman	1
foto-foto_zaman	foto-foto	zaman	1
geliat_zaman	geliat	zaman	1
gerekan_zaman	gerekan	zaman	1
hewan_zaman	hewan	zaman	1
huru-hara_zaman	huru-hara	zaman	1
ingat_zaman	ingat	zaman	1
ini_zaman	ini	zaman	1
istilah_zaman	istilah	zaman	1
jadul_zaman	jadul	zaman	1
kala_zaman	kala	zaman	1
kalau_zaman	kalau	zaman	1
kampanye_zaman	kampanye	zaman	1
kan_zaman	kan	zaman	1
kecenderungan_zaman	kecenderungan	zaman	1
kecil_zaman	kecil	zaman	1
kehidupan_zaman	kehidupan	zaman	1
kemanjuan_zaman	kemanjuan	zaman	1
kemauan_zaman	kemauan	zaman	1
kembali_zaman	kembali	zaman	1
kemerdekaan_zaman	kemerdekaan	zaman	1
kepada_zaman	kepada	zaman	1
ker-tas_zaman	ker-tas	zaman	1
keting-galan_zaman	keting-galan	zaman	1
keuangan_zaman	keuangan	zaman	1
khususnya_zaman	khususnya	zaman	1
kini_zaman	kini	zaman	1
kisah_zaman	kisah	zaman	1
komikus_zaman	komikus	zaman	1
kondisi_zaman	kondisi	zaman	1
konsentrasi_zaman	konsentrasi	zaman	1
kuno_zaman	kuno	zaman	1
lain_zaman	lain	zaman	1
macam_zaman	macam	zaman	1
makam_zaman	makam	zaman	1
manusia_zaman	manusia	zaman	1
masehi_zaman	masehi	zaman	1
masih_zaman	masih	zaman	1
maupun_zaman	maupun	zaman	1
medali_zaman	medali	zaman	1
melewati_zaman	melewati	zaman	1
memahami_zaman	memahami	zaman	1
memang_zaman	memang	zaman	1
mengalami_zaman	mengalami	zaman	1
mengarus_zaman	mengarus	zaman	1
mengingatkan_zaman	mengingatkan	zaman	1
mengungkapkan_zaman	mengungkapkan	zaman	1
menjelaskan_zaman	menjelaskan	zaman	1
menolak_zaman	menolak	zaman	1
menunjukkan_zaman	menunjukkan	zaman	1
menyatakan_zaman	menyatakan	zaman	1
menyebutnya_zaman	menyebutnya	zaman	1
menyesuaikan_zaman	menyesuaikan	zaman	1
meski_zaman	meski	zaman	1
mobil-mobil_zaman	mobil-mobil	zaman	1
modernisasi_zaman	modernisasi	zaman	1
muda-mudi_zaman	muda-mudi	zaman	1
mulai_zaman	mulai	zaman	1
mungkin_zaman	mungkin	zaman	1
nabi-nabi_zaman	nabi-nabi	zaman	1
nilai-nilai_zaman	nilai-nilai	zaman	1
orang_zaman	orang	zaman	1
ordansi_zaman	ordansi	zaman	1
order_zaman	order	zaman	1
otak_zaman	otak	zaman	1
padi_zaman	padi	zaman	1
panggilan_zaman	panggilan	zaman	1
paradigma_zaman	paradigma	zaman	1
pe-ninggalan_zaman	pe-ninggalan	zaman	1
pejuang_zaman	pejuang	zaman	1
pejuang-pejuang_zaman	pejuang-pejuang	zaman	1
pemerintah_zaman	pemerintah	zaman	1
pendidikan_zaman	pendidikan	zaman	1
penting_zaman	penting	zaman	1
penyakit_zaman	penyakit	zaman	1
penyakit-penyakit_zaman	penyakit-penyakit	zaman	1
peperangan_zaman	peperangan	zaman	1
peradaban_zaman	peradaban	zaman	1
perekembangan_zaman	perekembangan	zaman	1
pergantian_zaman	pergantian	zaman	1
pergerakan_zaman	pergerakan	zaman	1
pergumulan_zaman	pergumulan	zaman	1
perjuangan_zaman	perjuangan	zaman	1
permulaan_zaman	permulaan	zaman	1
perompak_zaman	perompak	zaman	1
persenjataan_zaman	persenjataan	zaman	1
perunggu_zaman	perunggu	zaman	1
plesetan_zaman	plesetan	zaman	1
ponsel_zaman	ponsel	zaman	1
proses_zaman	proses	zaman	1
raksasa_zaman	raksasa	zaman	1
riwayat_zaman	riwayat	zaman	1
roti_zaman	roti	zaman	1
rumah_zaman	rumah	zaman	1
saban_zaman	saban	zaman	1
satu_zaman	satu	zaman	1
saya_zaman	saya	zaman	1
sebagai_zaman	sebagai	zaman	1
sebagus_zaman	sebagus	zaman	1
sedjak_zaman	sedjak	zaman	1
segala_zaman	segala	zaman	1
sekalipun_zaman	sekalipun	zaman	1
sekolah_zaman	sekolah	zaman	1
semenjak_zaman	semenjak	zaman	1
sementara_zaman	sementara	zaman	1
semua_zaman	semua	zaman	1
seragam_zaman	seragam	zaman	1
setelah_zaman	setelah	zaman	1
sudah_zaman	sudah	zaman	1
sulit_zaman	sulit	zaman	1
tanda_zaman	tanda	zaman	1
tapi_zaman	tapi	zaman	1
teknologi_zaman	teknologi	zaman	1
tema_zaman	tema	zaman	1
tengah_zaman	tengah	zaman	1
tentang_zaman	tentang	zaman	1
tergilas_zaman	tergilas	zaman	1
tergusur_zaman	tergusur	zaman	1
terhadap_zaman	terhadap	zaman	1
tertinggal_zaman	tertinggal	zaman	1
tetapi_zaman	tetapi	zaman	1
top_zaman	top	zaman	1
tua_zaman	tua	zaman	1
tuntutan-tuntutan_zaman	tuntutan-tuntutan	zaman	1
ujian_zaman	ujian	zaman	1
ulama_zaman	ulama	zaman	1
warisan_zaman	warisan	zaman	1
wartawan_zaman	wartawan	zaman	1
ya_zaman	ya	zaman	1
zaman_2000-an	zaman	2000-an	1
zaman_akan	zaman	akan	1
zaman_apa	zaman	apa	1
zaman_apalagi	zaman	apalagi	1
zaman_apapun	zaman	apapun	1
zaman_ashra	zaman	ashra	1
zaman_awal	zaman	awal	1
zaman_bahkan	zaman	bahkan	1
zaman_baik	zaman	baik	1
zaman_bandar	zaman	bandar	1
zaman_bangsa	zaman	bangsa	1
zaman_bapak	zaman	bapak	1
zaman_barbar	zaman	barbar	1
zaman_begitu	zaman	begitu	1
zaman_belum	zaman	belum	1
zaman_berikut	zaman	berikut	1
zaman_berjuang	zaman	berjuang	1
zaman_canggih	zaman	canggih	1
zaman_da-hulu	zaman	da-hulu	1
zaman_dalam	zaman	dalam	1
zaman_dari	zaman	dari	1
zaman_datangnya	zaman	datangnya	1
zaman_dia	zaman	dia	1
zaman_distribusi	zaman	distribusi	1
zaman_disulap	zaman	disulap	1
zaman_doeloe	zaman	doeloe	1
zaman_dulukala	zaman	dulukala	1
zaman_era	zaman	era	1
zaman_gamelan	zaman	gamelan	1
zaman_geliat	zaman	geliat	1
zaman_generasi	zaman	generasi	1
zaman_globalisasi	zaman	globalisasi	1
zaman_guru	zaman	guru	1
zaman_harus	zaman	harus	1
zaman_hidup	zaman	hidup	1
zaman_inilah	zaman	inilah	1
zaman_jadi	zaman	jadi	1
zaman_jamu	zaman	jamu	1
zaman_jika	zaman	jika	1
zaman_juga	zaman	juga	1
zaman_justru	zaman	justru	1
zaman_kaligrafi	zaman	kaligrafi	1
zaman_kami	zaman	kami	1
zaman_kampanye	zaman	kampanye	1
zaman_kapolda	zaman	kapolda	1
zaman_karena	zaman	karena	1
zaman_kariernya	zaman	kariernya	1
zaman_ke-bodohan	zaman	ke-bodohan	1
zaman_ke-lahiran	zaman	ke-lahiran	1
zaman_kebebasan	zaman	kebebasan	1
zaman_kebutuhan	zaman	kebutuhan	1
zaman_kege-lapan	zaman	kege-lapan	1
zaman_kegelapan	zaman	kegelapan	1
zaman_kegembiraan	zaman	kegembiraan	1
zaman_kegemilangan	zaman	kegemilangan	1
zaman_kekhalifahan	zaman	kekhalifahan	1
zaman_kekuasaan	zaman	kekuasaan	1
zaman_kelak	zaman	kelak	1
zaman_keluarga-keluarga	zaman	keluarga-keluarga	1
zaman_kemapanan	zaman	kemapanan	1
zaman_kepimpinan	zaman	kepimpinan	1
zaman_keramik	zaman	keramik	1
zaman_kertas	zaman	kertas	1
zaman_kesenian	zaman	kesenian	1
zaman_kesetaraan	zaman	kesetaraan	1
zaman_khalifah	zaman	khalifah	1
zaman_khususnya	zaman	khususnya	1
zaman_kiwari	zaman	kiwari	1
zaman_klasik	zaman	klasik	1
zaman_kompeni	zaman	kompeni	1
zaman_komputer	zaman	komputer	1
zaman_komputerisasi	zaman	komputerisasi	1
zaman_korup	zaman	korup	1
zaman_kuda	zaman	kuda	1
zaman_lanjut	zaman	lanjut	1
zaman_leluhur	zaman	leluhur	1
zaman_ma-ka	zaman	ma-ka	1
zaman_majapahit	zaman	majapahit	1
zaman_maju	zaman	maju	1
zaman_manusia	zaman	manusia	1
zaman_materialisme	zaman	materialisme	1
zaman_materialistis	zaman	materialistis	1
zaman_media	zaman	media	1
zaman_melek	zaman	melek	1
zaman_membawa	zaman	membawa	1
zaman_membuat	zaman	membuat	1
zaman_menjadi	zaman	menjadi	1
zaman_menterinya	zaman	menterinya	1
zaman_menu-ju	zaman	menu-ju	1
zaman_menuntut	zaman	menuntut	1
zaman_merupakan	zaman	merupakan	1
zaman_mesolitik	zaman	mesolitik	1
zaman_misalnya	zaman	misalnya	1
zaman_mulai	zaman	mulai	1
zaman_namanya	zaman	namanya	1
zaman_namun	zaman	namun	1
zaman_nari-nari	zaman	nari-nari	1
zaman_nggak	zaman	nggak	1
zaman_niscaya	zaman	niscaya	1
zaman_orang	zaman	orang	1
zaman_order	zaman	order	1
zaman_otonomisasi	zaman	otonomisasi	1
zaman_otoriter	zaman	otoriter	1
zaman_pasca-Orba	zaman	pasca-Orba	1
zaman_pe-merintahan	zaman	pe-merintahan	1
zaman_pemerintah	zaman	pemerintah	1
zaman_pemerintahannya	zaman	pemerintahannya	1
zaman_pencerahan	zaman	pencerahan	1
zaman_penja-jahan	zaman	penja-jahan	1
zaman_per-janjian	zaman	per-janjian	1
zaman_peradaban	zaman	peradaban	1
zaman_perikanan	zaman	perikanan	1
zaman_perunggu	zaman	perunggu	1
zaman_perupa	zaman	perupa	1
zaman_postmodern	zaman	postmodern	1
zaman_pra-Islam	zaman	pra-Islam	1
zaman_presiden	zaman	presiden	1
zaman_produk	zaman	produk	1
zaman_produk-produk	zaman	produk-produk	1
zaman_progresif	zaman	progresif	1
zaman_ragam	zaman	ragam	1
zaman_raja	zaman	raja	1
zaman_reaktor	zaman	reaktor	1
zaman_rektornya	zaman	rektornya	1
zaman_renaisans	zaman	renaisans	1
zaman_riuhnya	zaman	riuhnya	1
zaman_sebagai	zaman	sebagai	1
zaman_sebe-lum	zaman	sebe-lum	1
zaman_sehingga	zaman	sehingga	1
zaman_seka-rang	zaman	seka-rang	1
zaman_selalu	zaman	selalu	1
zaman_semoga	zaman	semoga	1
zaman_seperti	zaman	seperti	1
zaman_serta	zaman	serta	1
zaman_sosial	zaman	sosial	1
zaman_tahun	zaman	tahun	1
zaman_tantangan	zaman	tantangan	1
zaman_tari	zaman	tari	1
zaman_tarifnya	zaman	tarifnya	1
zaman_teknik-teknik	zaman	teknik-teknik	1
zaman_telah	zaman	telah	1
zaman_terbiasa	zaman	terbiasa	1
zaman_terjadinya	zaman	terjadinya	1
zaman_tertentu	zaman	tertentu	1
zaman_terutama	zaman	terutama	1
zaman_tetap	zaman	tetap	1
zaman_tetapi	zaman	tetapi	1
zaman_tidak	zaman	tidak	1
zaman_turun-temurun	zaman	turun-temurun	1
zaman_tuturnya	zaman	tuturnya	1
zaman_ucapnya	zaman	ucapnya	1
zaman_ujarnya	zaman	ujarnya	1
zaman_ung-kap	zaman	ung-kap	1
zaman_upacara	zaman	upacara	1
zaman_virtual	zaman	virtual	1
ziarah_zaman	ziarah	zaman	1
